Complete Linux Operating System.
Kubuntu/Ubuntu/Debian-compatible.
Multimedia-codecs installed.


Features:

   GNU/Linux OS
   KDE - Desktop
   LibreOffice - Office Suite 
   Firefox - Browser
   Thunderbird - Email Client
   VLC - Media Player
   Kdenlive - Video Editor 
   Tomahawk - Music Player
   QMMP - Winamp for Linux
   Skype - VoIP Messenger
   Transmission - Bittorrent-Client
   Pidgin - Messenging Client
   Kdenlive - Video Editor
   Gimp - Graphic Program
   Krita - Paint Program
   Gwenview - Image Viewer
   VirtualBox - Computer Emulation
   Wine - Windows Emulation

Mozilla Firefox Add-Ons:

   KDE integration
   Flash-Plugin   
   Java-Plugin
   Adblock Plus
   Downloadhelper
   Add to Search Bar
   

For more information visit: http://www.netrunner-os.com	