[TRACKLIST]

Sun Control Species - Two Point Five
Aly & Fila - Key Of Life
Flowjob - Change Everything
Armin Van Buuren - Imagine
Ticon - 1987
Cerf & Mitiska feat. Jaren - You Never Said
Antix - Circade
The Doppler Effect - Beauty Hides In The Deep
Elegant Universe - Fractal
Eric Prydz - Pjanoo
Kliment - Pure Form
Kyau & Albert - Hide & Seek
Perfect Stranger & Pena - Ode Ao Sol
First State feat. Elliot Johns - Your Own Way
Zen Mechanics - Environmental Porn
Lange feat. Sarah Howells - Out Of The Sky
Atmos - KNS
Markus Schulz - The New World
Nyquist - Ghost Rider
Morgan Page feat. Lissie - The Longest Road
Ace Ventura - Presence
OceanLab - Sirens of the Sea
Excession - Cerberus
Orjan Nilsen - La Guitarra
Perfect Stranger - What's the Lineup?
Rank 1 vs. Jochen Miller - And Then..
Trancemission - Groovy Tuesday
Richard Durand - Weep
Bjorn Mandry & Thomas Gold - Suppress You
Solarstone - Forever
Fiord - Odyssey House
Sunlounger feat. Zara - Lost
Earsugar - New Era
The Thrillseekers feat. Fisher - The Last Time
Freq - Beat Street
4 Strings - Take Me Away
Gaudium - Beers, Drugs & Hoookers
Andy Moor - Fake Awake
Lish - Dirty Feelings
Allure feat. Julie Thompson - Somewhere Inside

:: Compiled and Uploaded by XaU Radio ::