Adventure Club - Wait (Cut From W&W Set)-enTc.mp3
Aligator Feat. Daniel Kandi - The Perfect Match (Club Version) (ASOT 565 Rip)-enTc.mp3
Andain - Turn Up the Sound (Xtigma Remix) (GDJB Rip)-enTc.mp3
Andy Duguid Featuring Lizzie Curious - Music Box (Dub Mix) (GDJB Rip)-enTc.mp3
Anumarity - To Be Ok (Original Mix) (Cut From Jerom Set)-enTc.mp3
Ashley Wallbridge feat. Audrey Gallagher - Bang the Drum (Omnia Remix) (ASOT 565 Rip)-enTc.mp3
Broning - New Dimension (Dart Rayne & Yura Moonlight Remix) (GDJB Rip)-enTc.mp3
Danilo Ercole - Futura (Wellenrausch Remix) (GDJB Rip)-enTc.mp3
Ehren Stowers - Phase 2 (Original Mix) (Cut From Tyas Set) (┬½ΓÇó┬╗)-enTc.mp3
Ernesto vs. Bastian - Who's the Starter (Paul Trainer Remix) (GDJB Rip)-enTc.mp3
Gaia - Jai Envie De Toi (Tom Fall Remix) (Cut From W&W Set)-enTc.mp3
Gareth Emery & Ashley Wallbridge - Mansion (Porter Robinson Edit) (Cut From W&W Set)-enTc.mp3
Jimmy Chou - Stardust Memory (New World Remix) (Cut From Saux Set) (┬½ΓÇó┬╗)-enTc.mp3
Johan Malmgren - Come Back (Cut From W&W Set)-enTc.mp3
Khomha - Days Gone Bye (Intro Mix) (GDJB Rip)-enTc.mp3
KhoMha - The Dark Knight (ASOT 565 Rip)-enTc.mp3
Magnetic Brothers - Looking Into Her Eyes Like a Sky (Magnetic Brothers Remix) (GDJB Rip)-enTc.mp3
Mark Burton - Inti (Original Mix) (Cut From Bostock Set) (┬½ΓÇó┬╗)-enTc.mp3
Mark Burton - Violator (Original Mix) (Cut From Bostock Set) (┬½ΓÇó┬╗)-enTc.mp3
Markus Schulz Featuring Adina Butar - Caught (Club Mix) (GDJB Rip) (┬½ΓÇó┬╗)-enTc.mp3
Matthew Nagle - Spike (Electro Mix) (Cut From Bin Fin Set) (┬½ΓÇó┬╗)-enTc.mp3
Moonbeam - Ghost (Lowboys in the Dark Remix) (GDJB Rip) (┬½ΓÇó┬╗)-enTc.mp3
Shane 54 And Abel Ramos - Kippevelmeter (Manuel Le Saux 2012 Remix) (Cut From Saux Set)-enTc.mp3
Stoneface & Terminal - Here Comes The Sun (Club Mix) (ASOT 565 Rip)-enTc.mp3
Sy Gardner - Concentrated Thought (Cut From Tyas Set) (┬½ΓÇó┬╗)-enTc.mp3
Sy Gardner - I Wish You Knew (Original Mix) (Cut From OzzyXPM Set)-enTc.mp3
Tim Preijers pres. Sense Of Shiver feat. Boom - Offshore (Temple One Perfect Ten Remix) (Cut From Saux Set)-enTc.mp3
UNKNOWN - UNTITLED (Rodrigo Deem Remix) (Cut From Bin Fin Set)-enTc.mp3
Vla-D - Beyond Borders (Original Mix) (Cut From Jerom Set)-enTc.mp3
Walsh & McAuley meets Sly One Vs Jurrane - In This Light (Sly One vs Juranne Mix) (Cut From Tyas Set) (┬½ΓÇó┬╗)-enTc.mp3
