50 Cent f.Dr. Dre & Alicia Keys - New Day
Adam Lambert - Never Close Our Eyes (R3hab Radio Edit)
Alesso, Matthew Koma - Years (Acoustic Version)
Alex Clare - Too Close (Jason Nevins Radio Mix)
Andy Grammer - Miss Me (Promo Only Clean Edit)
Angelique Sabrina - Pull  Up (Smash Mode Radio Edit)
At Sunset - This Is Who I Am
Big Time Rush - Windows Down
Bloc Party - Octopus
Boys Like Girls - Be Your Everything
Bridgit Mendler - Ready Or Not
Ca$h Out - Big Booty (Promo Only Clean Edit)
Cher Lloyd - Want U Back (Cahill Radio Remix)
Cher Lloyd - With Ur Love
Chief Keef - I Don't Like (Promo Only Clean Edit)
Chris Richardson f.Tyga - Joy & Pain
Chris Richardson Feat Tyga - Joy & Pain
Christopher S. feat. Nalaya - Let u go (Radio Edit)
Clinton Sparks f.Pitbull & Disco Fries - Watch You
Cody Simpson f.Becky G - Wish U Were Here
Dappy - Good Intention
Dave Matthews Band - Mercy
Deadmau5 f.Gerard Way - Professional Griefers
DJ Scream f.Future, 2 Chainz, Gucci Mane, Waka Flocka Flame & Yo Gotti - Hoodrich Anthem (Promo Only Clean Edit)
DJ Scream Feat Rick Ross, Slim Thug & Bun B - Cassette Deck
Eleftheria Eleftheriou - Hearts Collide
Florence & The Machine - Spectrum (Say My Name) (Calvin Harris Remix)
G-Dragon - That XX
Green Day - Oh Love
Grouplove - Itchin' On A Photograph
Hurt - Caught In The Rain (Promo Only Clean Edit)
Jaisa - Look At Me Now
Japandroids - The House That Heaven Built
Jayme Dee - Tip Toes
JEFF The Brotherhood - Sixpack
Jewel - Flower
Joe Zangie - When The Night Comes (Beat Thrillerz Radio Mix)
Kanye West & Pusha T - New God Flow
Karmin - Hello
Kaskade f.Neon Trees - Lessons In Love
Kelly Rowland f.Lil Wayne - Ice (Promo Only Clean Edit)
Kendrick Lamar - Swimming Pools (Drank) (Promo Only Clean Edit)
Kimberley Locke - Finally Free (Smash Mode Radio Edit)
Kottonmouth Kings - Mr. Cali Man
Krewella - Alive
Kristina Maria - Our Song Comes On
Lee M With J Pearl f.Iyaz & Snoop Dogg - Slow Motion
Lupe Fiasco - Bitch Bad
Mac Miller - Missed Calls
Manika - Good Girls
Mariah Carey f.Rick Ross & Meek Mill - Triumphant (Get 'Em)
Maroon 5 - One More Night (Promo Only Clean Edit)
MGK f.Ester Dean - Invincible
Miguel - Adorn
My Morning Jacket - Outta My System
Ne-Yo - Let Me Love You
Nickelback - Trying Not To Love You
No Doubt - Settle Down
Of Monsters And Men - Mountain Sound
One Direction - Live While We're Young
Orange Avenue - As You Fall
Paper Tongues - Amen
Pitbull f.Shakira - Get It Started
Ponderosa - Navajo
Reach For The Stars - will.i.am (Mars Edition) [2012]
Rick Ross f.Dr. Dre & Jay-Z - 3 Kings (Promo Only Clean Edit)
Rita Ora f.Tinie Tempah - R.I.P. (Seamus Haji Radio Edit)
Rita Ora f.Tinie Tempah - R.I.P.
Sammy Adams - Only One (Promo Only J.O.B. Clean Remix Edit)
Scissor Sisters - Let's Have A Kiki (Almighty Super Clean Radio Edit)
Sean Paul f.Kelly Rowland - How Deep Is Your Love (Promo Only Smash Mode Clean Radio Edit)
Silver Medallion - Stay Young
Snoop Lion - La La La
Sted-E & Hybrid Heights f.Mr. V - See U Move (Clean Radio Mix)
T.I. - Go Get It (Promo Only Clean Edit)
Taio Cruz - Fast Car
The Afghan Whigs - Lovecrimes
The Drowning Men - Lost In A Lullaby
The Early November - In Currents
The Head And The Heart - Ghosts
The Heavy - What Makes A Good Man
The House Rejects f.STAB - Exposure (Vocal Radio Mix)
The Lumineers - Ho Hey
The Used - Put Me Out
Trey Songz - Dive In
Usher - Scream (Fuego Radio Remix)
V.I.C. - Twerk It (Promo Only Clean Edit)
Waka Flocka Flame f.Nicki Minaj, Tyga & Flo Rida - Get Low (Promo Only Clean Edit)
Whitney Houston - His Eye Is On The Sparrow
Wiz Khalifa f.2 Chainz - It's Nothing (Promo Only Clean Edit)
Wonder Girls f.Akon - Like Money
Yeasayer - Longevity
Youngblood Hawke - We Come Running
