Before The Revolution: A 1909 Recording Expedition In The Caucasus & Central Asia By The Gramophone Company (CDvbr)

01. Kudari Zarond Lechi Zarag	 - Uarziev	 	 
02. Lezghinka - Oganez	 	 
03. Asup Khubada - Aslan-Bek Samtiev	 	 
04. Lezghinka - Bagrat	 	 
05. Aya-Duniya Pana Duniya - Shagab Molla Sagaibov	 	 
06. En inch man er Ark'ayankan - Bagrat Bagramiants	 	 
07. Lezghinka - Bagrat Bagramiants	 	 
08. Ekhlandeli Kalebi - Nikol Baveyants	  
09. bayati Shiraz Katar - Jabbar Karyagdy	 	 
10. Alagyaz Badzr Sar E - Vahan Ter-Arakelian	  
11. Kovsan - Seid Mahamet	 	 
12. Rafti Illoi Falang	 - Mugzin, Amroboi & Oibek	 
13. Sarvinaz - Lyubimets David Inoyatov	 	 
14. Khudoyar Khan - Khasiyat Khan	 	 
15. Marsh ishvoi - Turdi-Ali	 	 
16. Khazrat Sultan - Bai-Jan Baichimanov		 
17. Soki yamat Jigi-jigi - Taji-Khan Khajimetova	 
18. Sowti Sini Khorosh Pt 2 - Sadyr-Khan Baba Sharifov	  
19. Rok Mashki - Rai Khan	  
20. Suvora Andizhany - Gafrujonaksakol & Alimboi Masadyk-Ogly		 
21. Mushagaran kashkarcha - Sadyk Mullo	 
22. Sanor Ayty Khudoga - Akhmat-Boa& Abdu-Karim Jon	  
23. Arzimni Aytay Body Saboga Pt 1 - Mulla Tuichi Hafiz & Shabarat	