 9th Wonder  Murs - Tale Of Two Cities.mp3
 Bo Deal - Gun Clap (Ft. Chief Keef & Uncle Murda).mp3
 Capo (Alabama) - Handle Mine (Ft. Trae Tha Truth).mp3
 Chase N Cashe - Beastin (Ft ASAP Rocky).mp3
 DJ Fresh - Pussy Got Slap (Ft. E 40 & Freddie Gibbs).mp3
 Game - Holy Water.mp3
 Gudda Gudda - As Da World Turns (Ft. Lil Wayne & Mack Maine).mp3
 Gudda Gudda - Enemies (Ft.Crooked I, Ace Hood & Trae Tha Truth).mp3
 Gudda Gudda - I'm Gudda (Ft. Tity Boi & T-Streets).mp3
 Haitian Fresh - Watch You Shine (Ft. B.o.B. & Wyclef Jean).mp3
 Harry Fraud - Mean (Ft. French Montana & Action Bronson).mp3
 Jag - Dont Make Me (Ft. Fred The Godson).mp3
 Jahlil Beats - Aint No Turning Around (Ft. Yo Gotti & Jadakiss).mp3
 JP Beats - All In Together Now (Ft. Heltah Skeltah, Keith Murray & Homeboy Sandman).mp3
 Juicy J - Know Betta (Ft. Wiz Khalifa).mp3
 Kid Ink - Hell & Back (Remix) (Ft. Machine Gun Kelly).mp3
 King Louie - I Love Money (Ft. Lil Durk).mp3
 Masta Killa - R U Listening.mp3
 Mayalino - This Feeling (Ft. Pusha T).mp3
 Pac Div - Cross-Trainers (Ft. Kendrick Lamar& Blu).mp3
 Peter Jackson - Help (Ft. Joe Budden & Emerson Brooks).mp3
 Ras Kass - Focus (Ft. ProVerb & Kendrick Lamar).mp3
 Rick Ross - Hold Me Back (Remix) (Ft. Gunplay,  French Montana, Yo Gotti & Lil Wayne) .mp3
 Smoke DZA -   Cold Water  (Ft. Al Doe & NYMlo).mp3
 Termanology - Hustlers Ringtone (Ft. Lil Fame & Bun B).mp3
 Terrace Martin - Living Life (Ft. Juicy J & Problem).mp3
 Trav - Presidential (Ft. Jim Jones & Lloyd Banks).mp3
 Troy Ave - Dope Boy (Hands Up) (Ft. N.O.R.E.).mp3
 Young Jeezy - We Done It Again.mp3
 Young Scooter - Street Lights (Ft. Gucci Mane & OJ Da Juiceman).mp3