Self Compiled


Track List:


Always - Erasure
Angelina - PSY
Best Days - Juice
Do You Believe in Me - Eric Gadd
Don't Make it Over - Sybil
Down that Road - Shara Nelson
Dreams - Gabrielle
Dying Inside - Timmy Thomas
Emotions - Mariah Carey
Finally - Ce Ce Peniston
Happy - Squareheads
Hey - Fatima Rainey
I Can See Clearly Now - Jimmy Cliff
I Love You Always Forever - Donna Lewis
I Love Your Smile - Shanice
Just Another Day - Jon Secada
Let Me In - Mike Francis
Let Me Love you Down - INOJ
Make it Easy on Me - Sybil
Never Knew Love Like This Before - Sonia
Oh Life - Des'ree
Say What You Want - Texas
Set Adrift on Memory Bliss - PM Dawn
Shy Guy - Diana King
Stars - Simply Red
This Time its Forever - Errol Brown
Too Many Walls - Cathy Dennis
Water Falls - TLC
You to Me are Everything - The Real Thing
You've Gotta Be - Des'ree
 

 