Well, just that, I downloaded the torrent from an older file, but it was removed from the piratebay, so I decided to reupload it.

Song list:

Band of Skulls - You're Not Pretty But You Got It Goin' On

Bassnectar - Empathy

Beware of darkness - Howl

Blue Ghosts Riverboat - Gamblers

Calvin Harris - We'll Be Coming Back (feat. Example)

Dead Sara - Weatherman.mp3	10 MB

Deadmau5 - Channel 42 (with Wolfgang Gartner)

Dispatch - Circles Around The Sun

Dizzee Rascal & Armand Van Helden - Bonkers

DJ Fresh feat. Dizzee Rascal - The Power

Foreign Beggars feat. Noisia - Contact

Icona Pop - I Love It (feat. Charli XCX)

Last Dinosaurs - Zoom

Lower Than Atlantis - Love Someone Else

Madeon - The City

Muse - Butterflies and Hurricanes

Mutemath - Allies

Nero - Won't You (Be There)

Polica - Violent Games

Rudimental feat. John Newman - Feel The Love

Run Riot - A Light Goes Off (Run Riot Remix)

Silent code - East Star

Silent Code - Night Train

Silent Code - Spell Bound

Skrillex Ft. The Doors - Break'n a Sweat (Original Mix)

Strange Talk - Cast Away.mp3	5.6 MB

The Chemical Brothers - Galvanize

The Maccabees - Unknown

The Vaccines - Bad Mood

The Who - Baba O'Riley

We Are The Ocean - The Road