suspect - look like a rapper
london posse - pass the rizla
D1 - crack bong
dubwoofa - the nightmare
wadadda - phob
dj evol - sickness
D1 - missin
time - the line
don skeleton - farigt
cyrus - silence
autechre - second peng threnody rmx
moldy - cod & chips
n-type - tolerance
howard maple - the beast
cyrus & distance - violate
benga - music box
trg & dub u - harajuku
16bit - shetme got fucked
silkie & harry craze - favela
succulent-c - frequency
the bug - jah war feat. flowdan loefah rmx
vex'd - 3rd choice loefah rmx
reso - holograms
tek step - step off
taz buckfaster - murda skank
foreign beggars vs vex┬┤d - bollocks
foreign beggars - hit that gash ruckspin hangin'ham mix ft dubbledge & kyza
dubwoofa - phantom subs
high rankin - escape from the hood
paradox - unnatural causes threnody rmx
XI - smoke signal
dubwoofa - dstruckt
parson - throw some ds
crysis - super villan
16bit - texaco
mathhead - parasites
dos4gw - murder
dubchild - wanna die
threnody - warning
blackham - the crusade
torqux - relentless 16bit rmx
tech itch - metal
LL cool J - mama said knock you out