30 PARRANDEROS DE SIEMPRE (Americana de Discos) 2002





TEMAS




DIEZ AÑOS DE PLAZO - JOSE A. BEDOYA Merengue (Jose J. Muñoz) 1956.

EL AVENTURERO - LOS TROVADORES DEL RECUERDO (Felix Ramirez - E. Arbelaez).

EL BRUJO - BUITRAGUITO (Julio San Juan).

EL CARRANCHIL - GILDARDO MONTOYA (Gildardo Montoya).

EL DERROTERO - LOS TROVADORES DEL RECUERDO (Felix Ramirez).

EL DUENDE ALEGRE - OCTAVIO MESA (Pedro Nel Isaza).

EL MILAGRO SE HA HECHO - LUCHO YEPEZ (Lucho Yepez).

EL MONO MARINILLO - GILDARDO MONTOYA (Gildardo Montoya).

EL PASEO EN AUTOMOVIL - LAS AVES CANTORAS (Ana Leticia Moreno).

EL PRIMERO DE ENERO - LAS AVES CANTORAS (Ana Leticia Moreno).

EL RATON - AGUSTIN BEDOYA (Jose Muñoz - Agustin Bedoya) Version 1.

EL TAXISTA MALICIOSO - LUCHO EL FIESTERO & INES MARIELA (Anibal Jaramillo M.).

EL VERRACO DE GUACA - TOCAYO RAMIREZ (Pedro Nel Isaza).

INES VENITE PA' CA - ANTONIO POSADA (Antonio Posada).

LA AVISPA - LOS TUMAQUEÑOS, CANTA LUIS A. YAKUP (Luis Alberto Yakup).

La Mujer y la Gasolina - Libardo Alvarez PORRO (J. Villegas - L. Alvarez).

LA NARANJA MADURA - LOS BELLADINOS, CANTA JOAQUIN ACEVEDO (Abel Diaz - Jose Muñoz).

LA NIÑA EXIGENTE - CONSUELO PEREZ Y ANTONIO COLORADO (Pancho del Prado).

LA PIERNA PELUDA - EL MONO GONZALEZ (Francisco Gonzalez).

LA SALIDA DE ANIMALES - EL MONO GONZALEZ (Francisco Gonzalez).

LAS TROVAS DE YARUMAL - JOAQUIN BEDOYA (Jose Muñoz - Joaquin Bedoya).

MARIA LUISA - ANTONIO POSADA (Antonio Posada).

MARIA TERESA - LEONEL OSPINA (Pancho del Prado).

METALE CANDELA AL MONTE - DUETO HORIZONTE (Hermanos Giraldo).

MI PRIMER AMOR - JOSE A. BEDOYA (Jose Muñoz).

QUE LO DIGA ELLA - ANTONIO POSADA (Antonio Posada).

RELAJO DE CHOFERES - JOAQUIN BEDOYA (Gildardo Montoya - Joaquin Bedoya).

TRINIDAD - LOS PLAYER'S (Heli Toro).

YA NACIO EL NIÑO - LEONEL OSPINA (Maria Alvarez viuda de C. W. Andrade).

YO LE RESUELVO - JOSE A. BEDOYA (Rafael Carmona) 1956




