Eduardo Manostijeras
TÍTULO ORIGINAL 	Edward Scissorhands
AÑO 	1990
DURACIÓN 	
Trailers/Vídeos
98 min.
PAÍS 	
Sección visual
[Estados Unidos]
DIRECTOR 	Tim Burton
GUIÓN 	Caroline Thompson
MÚSICA 	Danny Elfman
FOTOGRAFÍA 	Stefan Czapsky
REPARTO 	Johnny Depp, Winona Ryder, Dianne Wiest, Anthony Michael Hall, Alan Arkin, Kathy Baker, Vincent Price, Caroline Aaron, Robert Oliveri
PRODUCTORA 	20th Century Fox
PREMIOS 	1990: Nominada al Oscar: Mejor maquillaje
GÉNERO 	Fantástico. Drama. Romance | Película de culto
SINOPSIS 	Durante una noche de Navidad, una anciana le cuenta a su nieta la historia de Eduardo Manostijeras (Johnny Depp), un muchacho creado por un extravagante inventor (Vincent Price) que no pudo acabar su obra, dejando al joven con cuchillas en lugar de dedos. (FILMAFFINITY)
CRÍTICAS 	----------------------------------------
"Obra maestra del cine moderno que, en su estreno, no fue recibida como se merece, pero que, con los años, se impone como una de la mejores películas de la historia del cine" (Javier Ocaña: Cinemanía) 