Science For Everyone


Differential Equations In Applications - AMELKIN, V. V.

Discussions On Refraction Of Light - TARASOV, L. V., TARASOVA, A. N.

Electrons And Crystals - WOLKENSTEIN, Th.

Elementary Kinematics Of Elementary Particles - KOPYLOV, G. I.

Encounters With Physics And Physicists - KIKOIN, I. K.

Flying Trains - ZELKIN, G.

How We See What We See - DEMIDOV, V.

In The World Of Binary Stars - LIPUNOV, V. M.

Luminiscence In Public Health - BARASHKOV, N. N.

Me Or Not Me - PETROV, R. V.

Our Planet, The Eart - BYALKO, A. V.

Percolation Theory, Physics And Geometry Of Disorder - EFROS, A. L.

Physical Paradoxes And Sophisms - LANGE, V. N.

Physics In Your Kitchen Lab - KIKOIN, I.K.

Problems In Physics (Aptitude Test) - KROTOV, S. S.

Problems In Plane Geometry - SHARYGIN, I. F.

Problems In Solid Geometry - SHARYGIN, I. F.

Satellite And Typhoon - BAIBAKOV, S., MARTYNOV, A.

Semi-conductors Made Simple - POLYAKOV, A. M.

Silhouttes Of Chemistry - TRIFONOV, D. N., VLASOV, L. G.

Storming Fortress Of Fusion - VORONOV, G. S.

Temperature - SMORODINKSY, Ya. A.

The Grand Biological Clock - DILMAN, V. M.

The Greatest Speed - FILONOVICH, S. R.

The Nature Of Magnetism - KAGANOV, M. I., TSUKERNIK, V. M.

The Progeny Of Volcanoes - EROFEEV, P. N.

This Fascinating Astronomy - KOMAROV, V. N.

Yes, No Or Maybe - KHURGIN, Ya. I.



UPLOADED BY: STIGMAA.

All Credits To: gnv64, damitr (mirtitles) & atisundar