Artista; Varios
Titulo: VA - (I love You)(tqm)(2012)
Bitrate: Mp3 320 Kbps
Tamaño: 266 Mb

CD 1
Pablo Alborán - Perdóname
Amaia Montero - Tu mirada
Sergio Dalma - El mundo
Malú - Ahora tú
Estopa - La primavera
La Oreja de Van Gogh - Cometas por el cielo
David DeMaría - La magia del corazón
Maldita Nerea - ¿No podíamos ser agua?
Hombres G con Miguel Bosé - Lo noto
Dani Martín - Mi lamento
La Musicalité - Soledad en mí
Presuntos Implicados - El amor me envuelve (Love is all around)
Bruno Mars - Marry You
Los Secretos - En este mundo raro
El Pescao - La luna va y viene
Vega - Como yo no hay dos
Pol 3.14 - Jóvenes eternamente

CD 2
Michel Teló - Ai se eu te pego
Pitbull, Ne-Yo, Afrojack & Nayer - Give Me Everything
Shakira - Antes de las seis
Bustamante - Como tú ninguna
Paulina Rubio - Me gustas tanto
Carlos Baute - Todo se olvida
Camila - De mí
Beatriz Luengo & Yotuel - Como tú no hay 2
Antonio Orozco - No hay más
India Martínez - Vencer al amor
El Sueño de Morfeo - Depende de ti
Rosana - Mi trozo de cielo
Pastora Soler - Demasiado amor
Melendi - Perdóname ángel
Despistaos - Los días contados
Huecco & Papillon - Amar en tiempos violentos