Dance Beat Explosion Vol. 48 [2012]

Tracklisting:

Intro

Brad Breaker - For The Time

Nigel Hard - Let Me Out

Paffendorf - Where Are You 2011

DJ Hyo - Everyday

Jan Wayne - Bring Me To Life

Maroon 5 feat. Christina Aguilera - Moves Like Jagger

PH Electro - Stereo Mexico

Discoduck - Everybody Rock

Mark Oh - Party To The Rooftop

N-Finity - Someone Like You

Dance Rocker - Push The Feeling On

Mark Ashley - Tango In The Night

Dansynergy - Das Gefuehl

Robkay feat. David Posor - Dein Lied

Cascada - Night Nurse

Dansynergy - Das GefÃ¼hl (Remix)

Glaukor - Loco

DJ Hyo - Special One

Dancefloor Kingz - Me & You

Basslovers United - Basket Case

Crystal Rock & Hornyshakerz - How Will I Know

Kris McTwain - My Passion

Sunnyboy - Almost Heaven

Michael Newton - Wow! (Hey, Hey)

Familiar Faces - Mad World

DJ Zkydriver - Do You Wanna Dance

Jaycee Madoxx - Never Say Never

Serenity & Spyer Feat.Tevin - Club Rockin Beats

Serenity & Spyer Feat.Tevin - Rokk The Floor

Hands Up Squad - Alice In Wonderland 2k12

Nikasoul - Sexy & Funny

Italobrothers feat. Carlprit - Boom

Jens O. vs.Ti-Mo - Give Take

Tss Proyect - Se Feliz

Darius & Finlay - Do It All Night

Tim De Ville feat. Alessa - Love Is An Ocean

Iby - Ho Dentro Te

Don Omar feat. Lucenzo - Danza Kuduro

Carmixer - Musica Magica

Salvo La Mela feat. Sheby - Let Me Stay Tonight

Basshunter - Long Way from Home

Quentin - Il Tipico Ragazzo

Persian Raver - You Are My Angel

Mariano & Marco vs. DPJ - My Star

Jasper Forks - River Flows

Surisan - The Only One
