Disque : 1

Gangnam style - Psy
Down the road - C2c
This is love - Will.I.Am
Elle t'a mate (fatoumata) - Keen' V
Good time - Owl City
Watibigali - Ali Big
Blow me (one last kiss) - P!Nk
Wanna see u dance (la la la) - Deluna Kat
Don't wake me up - Brown Chris
Groupie - Sinclar Bob
Summer jam - R.I.O.
You're gonna love again - Nervo
Ma demoiselle - Collectif Metisse
Kick out the epic motherf**ker - Dada Life
Stand on the word - Keedz
I see you - Ranx Jutty
Celebrate - Mika
Dame - Shaggy
Lights - Goulding Ellie
Back in time (featured in "men in black 3" - Pitbull


Disque : 2

She wolf (falling to pieces) - Guetta David
Balader - Sexion d'Assaut
One day / reckoning song - Avidan Asaf
Too close - Clare Alex
Numb - Usher
Let me love you (until you learn to love yourself) - Ne-Yo
Fiesta buena - Mam'S DJ
Summerbreeze - Stone & Van Linden
Revolution - Océan Drive
Fiesta - Carlprit
Damelo - Olmyta
Look inside - Billard Alexandre
You¿ll be mine - Brown Havana
Million voices - Knows Otto
Baby I'm yours - Breakbot
One by one - Morgan Laza
I rave you - Basto!
Addicted - DJ Assad
Bara bara bere bere - Ferrari Alex
Pound the alarm - Minaj Nicki
