192

Alanis Morissette - Empathy
Alanis Morissette - Receive
Alex Ferrari - Bara Barâ Bere Berê
Annalisa - Senza Riserva
B.o.B Feat Nicki Minaj - Out Of My Mind (Explicit)
Blinders - Gipsy Sunshine
Brandon Heath - Jesus In Disguise
Brooke Valentine - Rub It In 
Cali & El Dandee Feat. David Bisbal - No Hay 2 Sin 3 (Gol)
Cleo Sol - Never The Right Time (Who Do You Love)
Clinton Sparks (feat. Pitbull, Disco Fries)- Watch You
Dez - We Ride
Disturbed - Hell
DJ Khaled Feat Lil' Wayne, T.I. & Future - Bitches & Bottles (Let's Get It Started)
DJ Khaled Feat Nas, Scarface & DJ Premier - Hip Hop
Driicky Graham ft. Roscoe Dash & Ca$h Out & French Montana - Snapbacks & Tattoos (Remix)
Eldorado Red ft. YG Hootie - Million Dollar Condo
Ellie Goulding - Anything Could Happen
Emis Killa Club Dogo Jax Marracash - Se Il Mondo Fosse
Eric Turner and Avicii -Dancing In My Head (Tom Hangs Remix)
Flying Lotus Feat Erykah Badu - See Thru To U
Giorgia - Tu Mi Porti Su
Gotham Green ft. Freddie Gibbs & T. Mills - All I Know
Gotye - Save Me
Green Day - Oh Love
Hoobastank - No Destination
Il Pulcino Pio - Pulcino Pio
JD Era ft. Sarkodie - Turn It Up
Jori King - You Need Me
Jose De Rico & Henry Mendez - Rayos De Sol
Juan Magan - Ella Se Vuelve Loca (Pablonez Edit)
Kat Deluna Feat El Cata - Sobredosis
Kelly Clarkson - Get Up (A Cowboys Anthem)
Kid Cudi ft. King Chip - Just What I am
Laura Bell Bundy - That's What Angels Do
Ma Cherie - Dj Antoine
Mara Sophie - I Just Sing
Megan & Liz - Bad For Me
Melanie Amaro - Love Me Now.mp3
Michael Jackson - Bad (Afrojack Remix)
Moda - Come Un Pittore
Mumford & Sons - I will wait3
Natalia Feat Mr Rommel - Indomita (Remix)
Neon Hitch Feat Tyga - Gold
Nicki Minaj vs Pitbull - Give Me Every Starship
Non Vivo Piu Senza Te - Biagio Antonacci
Owl City - Im Coming After You
Owl City - Metropolis
P.E.S. - Club Dogo Giuliano Palma
P.O.D Lost In Forever (Scream)
Pixie Lott - Love You More
R.I.O. feat. Nicco - Party Shaker
Rita Ora - Radioactive
Rita Ora - What Makes You Beautiful
Ronan Keating - Fires
Ryan Star - Stay Awhile
Sean Kingston Feat Busta Rhymes - How We Survive
Sexion Dassaut-Wati House.mp3
SHY'M - Et Alors
Slaughterhouse - Goodbye
Swedish House Mafia Feat John Martin - Don't You Worry Child (Radio Edit)
Taylor Swift - We Are Never Ever Getting Back Together
The Wheeler Sisters - This Is Gonna Get Ugly
Three Days Grace - Chalk Outline
Travis Porter ft. JLA - Willy Wonka