lbum: Lo Mas Escuchado Noviembre 2012
Año: 2012
Género: Pop / Dance
Temas: 40
Callidad: MP3 / 320 Kbps
Tamaño: 340 MB


Lista de temas:

The Wanted - I Found You
Rita Ora - Shine Ya Light
Robbie Williams - Candy
Adele - Skyfall
Owl City & Carly Rae Jepsen - Good Time
Swedish House Mafia Feat John Martin - Don’t You Worry Child
Psy - Gangnam Style
Wiley Feat Ms D, Skepta & Jme - Can You Hear Me (Ayayaya)
Rihanna - Diamonds
Misha B - Do You Think Of Me
Labrinth Feat Emeli Sande - Beneath Your Beautiful
Calvin Harris Feat Florence Welch - Sweet Nothing
Sub Focus Feat Alpines - Tidal Wave
Maroon 5 - One More Night
Disclosure Feat Sam Smith - Latch
The Lumineers - Ho Hey
Lawson - Standing In The Dark
Calvin Harris Feat Tinie Tempah - Drinking From The Bottle
Justin Beiber Feat Nicki Minaj - Beauty And A Beat
Taylor Swift - We Are Never Ever Getting Back Together
Jason Mraz - I Won’t Give Up
The Script Feat Will.I.Am - Hall Of Fame
Pink - Try
Flo Rida - I Cry
Jls - Hottest Girl In The World
Paloma Faith - Never Tear Us Apart
Conor Maynard Feat Ne-Yo - Turn Around
Otto Knows - Million Voices
Ne-Yo - Let Me Love You
Naughty Boy Feat Emeli Sande - Wonder
Christina Aguilera - Your Body
David Guetta Feat Sia - She Wolf (Falling To Pieces)
Fun Feat Janelle Monáe - We Are Young
Willy Moon - Yeah Yeah
Sneakbo - Zim Zimma (Explicit Edit)
Gabrielle Aplin - The Power Of Love
One Direction - Live While We’re Young
Fun - Some Nights
Ellie Goulding - Anything Could Happen
Nicki Minaj - Va Va Voom (Explicit Edit)