Abfhart - Next Change (KEN-GEE & RYOJI TAKAHASHI Remix) (Set Rip)-enTc.mp3
Alex Bergheau - Colors Of Persia (ASOT 581 Rip)-enTc.mp3
Aneesh Gera vs. Harjy Boy - Carpe Diem (Original Mix) (Cut From KOHSUKE Set)-enTc.mp3
Apocalypto - Apocalypto (Original Mix) (Cut From Hedonist Set)-enTc.mp3
Arman Bahrami - Farewell (ASOT 581 Rip)-enTc.mp3
Armin van Buuren feat. Ana Criado - I'll Listen (Super8 & Tab Remix) (ASOT 581 Rip)-enTc.mp3
Ayda - Queen (ASOT 581 Rip)-enTc.mp3
Ayda - Queen (Original Mix) (Cut From Feel Set)-enTc.mp3
Beat Service - Impulse (ASOT 581 Rip)-enTc.mp3
Ben Gold feat. The Glass Child - Fall With Me (ASOT 581 Rip)-enTc.mp3
Blue Twinkle - Mindful (Tomoyuki Sakakida Remix) (Cut From Hashimoto Set)-enTc.mp3
Calla Soiled - ENTRANCEOFTHELAYER (Cut From Tomoyuki Set) (┬½ΓÇó┬╗)-enTc.mp3
Delerium feat. Michael Logen - Days Turn Into Nights (Solarstone Pure Mix) (ASOT 581 Rip)-enTc.mp3
Dilemn - Kill the Nation (Original Mix) (Cut From Hedonist Set)-enTc.mp3
DJ Yoko feat. MASMIN - Distance (Original Mix) (Cut From KOHSUKE Set)-enTc.mp3
Ewan Rill Feat. Reflection Soul - One Function (Jonatan Ramonda Remix)  (Cut From Fernie Set)-enTc.mp3
Fernie - A Brighter World (Science Deal Remix) (Cut From Moxa Set)-enTc.mp3
Flashtech - Memories (Silence Groove Remix) (Cut From ReOrder Set)-enTc.mp3
Frans Bak - The Killing (Armin van Buuren Remix) (ASOT 581 Rip) (┬½ΓÇó┬╗)-enTc.mp3
Front - Yossu (Dennis Sender Remix) (ASOT 581 Rip)-enTc.mp3
Hanski - Eyescore (Cut From MIKE Set)-enTc.mp3
Haruka Tamasaki - Luten (Original Mix) (Cut From Tomoyuki Set)-enTc.mp3
Hiroyuki ODA - Astaroth (Cut From Kenji Set) (┬½ΓÇó┬╗)-enTc.mp3
Ian Booth - Elevation (Cut From Booth Set)-enTc.mp3
Ilya Flame pres. Inners - Fluidum (KaNa Remix) (Cut From Kana Set)-enTc.mp3
Izu - Ice Arena (Yuki Kudo Remix) (Cut From KOHSUKE Set)-enTc.mp3
Izu - Relevancy (Original Mix) (Cut From Tomoyuki Set)-enTc.mp3
Izu - Yasashii Uso (Tomoyuki Sakakida Remix) (Cut From Tomoyuki Set) (┬½ΓÇó┬╗)-enTc.mp3
Julie Thompson & MaRLo - Broken Wing (Cut From Bobina Set)-enTc.mp3
Magdelayna -  Solar Nebular (Original Mix) (Set Rip)-enTc.mp3
Masanori Yasuda - What a Wonderful Summer (Prog Mix) (Cut From Masanori Set)-enTc.mp3
Max Braiman - Strarus (Original Mix) (Cut From OCOT Set)-enTc.mp3
MAYA AKAI - Hydrangea (Original Mix) (Cut From Hedonist Set)-enTc.mp3
Mike Foyle & Surpresa - Placebo (ASOT 581 Rip)-enTc.mp3
MKB - Katana (Markus Schulz Big Room Reconstruction) (GDJB Rip)-enTc.mp3
Nick Callaghan & Will Atkinson - Volare Via (Cut From Patterson Set)-enTc.mp3
Nogami - Midnight Loss (Original Mix) (Cut From KOHSUKE Set)-enTc.mp3
OCOT - Exit to Heaven (Original Mix) (Cut From OCOT Set)-enTc.mp3
Orjan Nilsen - Copperfield (ASOT 581 Rip)-enTc.mp3
Talla 2XLC - Stars (ASOT 581 Rip)-enTc.mp3
Tomas Heredia - Lost (Cut From Bobina Set)-enTc.mp3

