Akon - Hurt Somebody (without French Montana) (Dirty) 
B.o.B Ft. Taylor Swift - Both Of Us 
B.o.B. - So Hard To Breathe (Dirty) 
Chris Brown ft Big Sean and Wiz Khalifa - Till I Die (Dirty)
Colby O Donis - Like Me 
Diggy Simmons - Two Up (Clean) 
Fat Joe ft Chris Brown, Mary J Blige, Fabolous and Kirko Bangz - Another Round (Remix) (Dirty)
FloRida - Whistle
FloRida ft Trina and Pleasure P - Dumb (Dirty) 
French Montana ft Jadakiss, Styles P, Red Cafe, Fat Joe and Uncle Murda - Shot Caller (NYC REMIX) (Dirty) 
Future - Jordan Diddy (Dirty) 
Future ft R. Kelly - Parachute (Dirty) 
J. Cole - Sideline Story (Dirty) 
Jeremih - Go To The Mo  
Jeremih - Late Nights 
Kanye West ft Big Sean, Pusha T and 2 Chainz - Mercy (Dirty)
Kanye West ft DJ Khaled and DJ Pharris - Theraflu (Dirty)
Kendrick Lamar ft Dr Dre - The Recipe (Intro Outro) (Dirty)
Kevin McCall ft Big Sean - Naked (Dirty) 
Mario - Strangers 
Maroon 5 ft Wiz Khalifa - Payphone (Dirty) 
Mary J. Blige Ft. Drake - Mr. Wrong 
Nelly Furtado - Big Hoops (Bigger The Better) (Main) 
Nicki Minaj - HOV Lane (Dirty) 
Nicki Minaj ft Beenie Man - Gun Shot (Clean) 
Nox ft Rick Ross - You Aint Never (Dirty) 
Obie Trice - Richard (Dirty) 
Randyn Julius ft Jim Jones, CamRon and Teyana - Party Tonight (Dirty) 
Red Cafe - Game Over (Dirty) 
Red Cafe - Im The Best (Dirty) 
Rihanna ft Chris Brown and Fabolous - Birthday Cake (Remix) (Dirty)
Tyga ft Kurupt and YG - Bitch Betta Have My Money (Dirty) 
Warren G Nate Dogg and The Game - Party We Will Throw Now (Dirty) 
Wiz Khalifa - Work Hard Play Hard (Dirty)
