[img]http://images.amazon.com/images/G/01/richmedia/images/cover.gif[/img]

Disc 1
Jessie J - Domino
Katy Perry - Firework
Rihanna - Disturbia
Cee Lo Green - Forget You
Maroon 5 feat. Christina Aguilera - Moves Like Jagger
Flo Rida feat David Guetta - Club Can't Handle Me
Pitbull feat Ne-Yo, Afrojack & Nayer - Give Me Everything
LMFAO - Sexy And I Know It
Jennifer Lopez - On The Floor
David Guetta feat Kelly Rowland - When Love Takes Over
Mike Posner - Cooler Than Me
Duffy - Mercy
Sam Sparro - Black And Gold
Gwen Stefani - What You Waiting For?
A R Rahman & The Pussycat Dolls feat. Nicole Scherzinger - Jai Ho! (You Are My Destiny)
Calvin Harris - Ready For The Weekend
Nelly Furtado - Maneater
Example - Kickstarts
Peter Bjorn & John feat. Victoria Bergsman - Young Folks
The Temper Trap - Sweet Disposition
Coldplay - Paradise
Disc 2
Rizzle Kicks - Mama Do The Hump
Lady Gaga - Born This Way
Shakira - Waka Waka (This Time For Africa)
Yolanda Be Cool & D Cup - We No Speak Americano
Alexandra Stan - Mr Saxobeat
Avicii - Levels
Cascada - Evacuate The Dancefloor
Taio Cruz - Higher
Martin Solveig - Hello
Duck Sauce - Barbra Streisand
Swedish House Mafia vs. Knife Party - Antidote
Snoop Dogg vs David Guetta - Sweat
Darude - Sandstorm
Nero - Promises
La Roux - In For The Kill
Metro Station - Shake It
Black Eyed Peas - Pump It
Outkast - Hey Ya!
DJ Fresh feat. Sian Evans - Louder
Magnetic Man - I Need Air
Owl City - Fireflies
Disc 3
Tinie Tempah feat. Eric Turner - Written In The Stars
Jay-Z - 99 Problems
Survivor - Eye Of The Tiger
Salt 'N' Pepa - Push It
Lenny Kravitz - Are You Gonna Go My Way
The Cardigans - My Favourite Game
The Killers - Human
U2 - Beautiful Day
Stereophonics - Dakota
Florence & The Machine - Dog Days Are Over
The Fratellis - Chelsea Dagger
The Kaiser Chiefs - I Predict A Riot
Blondie - One Way Or Another
Michael Sembello - Maniac
Kenny Loggins - Footloose
OK Go - Here it Goes Again
Tina Turner - The Best
Bill Conti - Gonna Fly Now (Theme From "Rocky")