Signifying the dawn of reason of the XaU mission, I present you with classics from my two favourite music blogs - SeekSickSound and MildtoWild. Enjoy.

[Tracklist]

Sebastian Leger & Chris Lake - Word (Original Mix)
Tiga - Mind Dimension 2 (Soulwax Version)
Deadmau5 - Assorted
Mr. Oizo - Positif
Justin Garner - Alter Ego
Les Petits Pilous - Housi (Fckn Crew Remix)
The House Keepers - Hangin' On (Ian Carey Rework)
Lies In Disguise - Higherstate
Peaches - I Feel Cream (Proxy Remix)
Kap10kurt - Mission Complete (Ocelot Remix)
Federico Franchi - Pears (Joachim Garraud Remix)
Fact - Fog (The Bloody Beetroots Remix)
Gui Boratto - Atomic Soda (Original Mix)
Machines Don't Care - Beat Bang (Action Mans Tank Trax Remix)
Global Deejays ft. Technotronic - Get Up (Maurizio Gubellini Remix)
Klaxons - Gravity's Rainbow (Guns 'n' Bombs Remix)
Pryda - Reeperbahn (Original Mix)
Mr Oizo - Positif (Kaptain Cadillac Ghetto Remix)
Dusty Kid - The Cat (Drive Dealers Remix)
Proxy - Dance in the Dark (Noizy Kidz CCCP Remix)
Andy Duguid - Signals (Original Mix)
Tigersapien - Shake It Down
Noob & Brodinski - Peanuts Club (Madera Collins Remix)
The Sterehoes - Urgent
autoKratz - Stay The Same (Alex Gopher Remix)
Joe And Will Ask? - Surge
Super8 & Tab - Suru (Martin Roth Electrance Remix)
Stay Ali - Emotional Day (FutureFlash's Vocal Mix)
Giant - Drumstick
Digitalism - Echoes (Digitalism's Underwater Sonar Club Mix)
Alter Ego - Why Not?! (Original Mix)
DatA - Rapture (The Sterehoes Remix)
Vitalic - No Fun (Joachim Garraud Remix)
Surkin - White Night Two
Robot Needs Oil - The Day The World Ended
The Squire Of Gothos - Bounty Ice Cream
BSOD - Roflcopter (Original Mix)
Mustard Pimp - Zombie Revenge
Komytea - Electro House Is Dead (Original Mix)
Crystal Castles - Air War (Joe And Will Ask? Remix)
Alex Gopher - Handguns (Dada Life Remix)
Danger - 11h30 (Kurtech Remix)
DJ Mercer - No Stress On The Longest Road
Death From Above 1979 - Blood On Our Hands (Justice Remix)
Heiko & Maiko - Morseton
Fukkk Offf - Rave is King (Le Castle Vania Remix)
Mason - The Amsterdam Tape
Lies In Disguise - Meet Your Replacement
The Bloody Beetroots - House n 84 (FCKN Remix Final)
Notorious BIG - Party and Bullshit (In The USA Remix)
Fear of Tigers - Sirkka (Original Mix)
LAZRtag - Detonate (Dan Sena Remix)
Fake Blood - Mars (Original Mix)
Gooseflesh - Wet (Fukkk Offf Remix)
DatsiK - Subsonik
Fckn Crew - Carnage