50 Cen Feat Brevi - Be My Bitch
A Rocket To The Moon - Whole Lotta You
Alaine - Magnet 
August Vila - Im into you (olbaid remix)
Avicii Vs Lenny Kravitz - Superlove
BB Brunes - Coups Et Blessures
Bob Marley - Sun Is Shining (Nico Luminous Remix)
Brandon Heath - Jesus In Disguise
Brandy - Wildest Dreams
Brooke Valentine - Rub It In 
Bunji Garlin - August 
Busy Signal - NEXT ONE
D Lo (feat. Tyga) -  Get Her Tho
Daughtry - Rescue Me (Acoustic Version) 
Dave Days - Summertime
David Guetta -  Titanium (Spanish Version)
Elephant Man - Dance Away 
Ellie Goulding -  Anything Could Happen
Emeli Sandé - Imagine
Flying Lotus Feat Erykah Badu - See Thru To U
Flyleaf - New Horizons
Game Ft J. Black - Everywhere 
Gotye -  Dig Your Own Hole
Gotye -  Easy Way Out
Gucci Mane - Bussin Juugs
Hyland -  Beauty in the Broken
J.Reyez - Our Promise
Jayme Dee - Tip Toes
Keke Palmer - Dance Alone
Kelly Rowland feat. Lil Wayne - Ice
Kendrick Lamar Feat Young Jeezy - Westside, Right On Time
Krept & Konan Ft. Sneakbo & Siah - Light Up 
Lana Del Rey - Afraid 
Mann - Treal Talk 
Mayer Hawthorne - Get Ready
Megan & Liz - Bad For Me
Megan Nicole - B-E-A-Utiful
Megan Nicole - We Are Never Ever Getting Back Together
Mel Carter Ft. J Dot - Bad You Know 
Michael Jackson - Speed Demon (Nero Remix) 
Muse - Madness
Nitty Scott MC Ft. Kendrick Lamar - Flower Child 
Obi Trice -  Spill My Drink
PJ Morton Ft. Ledisi - Baby I Love U 
RDX - Pop Dance 
Remedy And Manu L - Single Ladies (Single Edit)
Ryan Cabrera - I See Love
ScHoolboy Q - Party
Skrillex & Wolfgang Gartner - The Devils Den
Slaughterhouse Feat Emin3m - Asylum
Sonny Flame - Lady (Radio Edit)
Styles P Ft. Trae Tha Truth & Fred The Godson - Throw Down 
Sultan & Ned Shepard Ft. Taryn Manning - Send Me Your Love (Original Mix) 
T.O.K - 10 Grand Fi A Hug 
Tamia - Because Of You 
The Wheeler Sisters - This Is Gonna Get Ugly
Tiffany Alvord - As Long As You Love Me
T-Pain - Don't You Quit 
Trey Songz - So Sophisticated (Triggamix)
Tryö - Greenwashing
