Cosmic Gate & Emma Hewitt - Calm Down (Ost & Meyer Remix) (TATW 448 Rip)-enTc.mp3
Danny Chen - Last Chance For Love (Cut From Ruben Set)-enTc.mp3
DDZ - Shiftiness (Cut From Claessen Set)-enTc.mp3
Elleu - Turbines (Cut From Pit Set) (┬½ΓÇó┬╗)-enTc.mp3
Fehrplay - Slab (Ian Beers Remix) (Cut From Valentine Set)-enTc.mp3
Flashtech - Horizons (Cut From Ruben Set) (┬½ΓÇó┬╗)-enTc.mp3
Fon Leman - Waterworld (Cut From Ruben Set)-enTc.mp3
Gareth Weston - Exotherm (Original Mix) (Cut From Kaeno Set) (┬½ΓÇó┬╗)-enTc.mp3
George Vemag - Saw Major (Chris Voro Remix) (Cut From Kaeno Set)-enTc.mp3
Hannah - Falling Away (Azima Remix) (Cut From Azima Set)-enTc.mp3
Jaytech feat. Melody Gough - Grey Horizon (Dayon Remix) (TATW 448 Rip)-enTc.mp3
Jey Verona - Friday (Azima Remix) (Cut From Azima Set)-enTc.mp3
Julians - Plan A (Cut From Jules Set)-enTc.mp3
Kaskade feat. Skylar Grey - Room For Happiness (Above & Beyond Remix) (TATW 448 Rip) (┬½ΓÇó┬╗)-enTc.mp3
Liam Wilson & The Technicians - Recovery (Original Mix) (Cut From Kaeno Set)-enTc.mp3
Marwen - What If We Never Met (Cut From Pit Set)-enTc.mp3
Matt Davey - Neutrino (Original Mix) (Cut From Davey Set)-enTc.mp3
Matt Skyer - Inside of You (Brian Flinn Remix) (Cut From Nadz Set) (┬½ΓÇó┬╗)-enTc.mp3
Meeke - Non Toxic (Cut From Myon Set)-enTc.mp3
Motif Feat. Pamela Nyambo - Strong (Danny Stubs Remix) (Cut From Shah Set)-enTc.mp3
Nab Brothers - Cosmic Symphony (Joe Shadows Remix) (Cut From Shadows Set) (┬½ΓÇó┬╗)-enTc.mp3
NDS & Blue - Amazonia (Denis Sender Remix) (Cut From Pit Set) (┬½ΓÇó┬╗)-enTc.mp3
Nikhil Prakash - Booyah (Original Mix) (Cut From Suzy Set)-enTc.mp3
Paw Luk - Love is (Azima Remix) (Cut From Azima Set) (┬½ΓÇó┬╗)-enTc.mp3
Peetu S - Bigger Palace (2012 Remake) (Cut From Davey Set)-enTc.mp3
Peter Plaznik - Blind Minded (Original Mix) (Cut From Kaeno Set)-enTc.mp3
Pop Art - Party Shaker (Cut From Kearney Set)-enTc.mp3
Project Offset - Grimlock (Original Mix) (Cut From Pit Set)-enTc.mp3
Rave CHannel - Te Quero (AzimaΓÇÖs Vox Remix) (Cut From Azima Set)-enTc.mp3
Reiklavik - Come To Me (Robert Holland & Iris Dee Jay Remix) (Cut From Suzy Set)-enTc.mp3
Ruben de Ronde & Aelyn - What About You (Mike Danis Remix) (Cut From Ruben Set)-enTc.mp3
Ruben de Ronde - Bad Hero (Cut From Ruben Set)-enTc.mp3
Russell G & Kellie Allen - Piece Of My Heart (Future Disciple Remix) (Cut From MIKE Set) (┬½ΓÇó┬╗)-enTc.mp3
S.Y.N.E.R.G.Y - Cosmic Dust (Azima Remix) (Cut From Azima Set)-enTc.mp3
Sedi - Below The Sky (Cut From MIKE Set)-enTc.mp3
Solid Stone - Refresh (Airsoul Remix) (TATW 448 Rip)-enTc.mp3
Spark7 - Bushido Hustle (Original Mix) (Cut From Suzy Set)-enTc.mp3
Speed Limits - Ode To The Wind (Juventa Remix) (TATW 448 Rip) (┬½ΓÇó┬╗)-enTc.mp3
Stuart Miller - No Fear (Cut From Jules Set)-enTc.mp3
The XX- Angels (J&T Project Remix) (Cut From Jules Set)-enTc.mp3
Transet & A4 - Life Circle (Azima Remix) (Cut From Azima Set)-enTc.mp3
Tritonal and Super8 & Tab - ARC (Instrumental Extended Mix) (Cut From Moor Set) (┬½ΓÇó┬╗)-enTc.mp3
Tritonal and Super8 & Tab - Arc (Original Mix) (TATW 448 Rip) (┬½ΓÇó┬╗)-enTc.mp3