ACDC - Highway to hell
Animals - House of the Rising Sun
Beach Boys - I Get Around
Bob Dylan - Blowing in the Wind
Bohemian Rhapsody - Queen
Bruce Springsteen - Born In The Usa
Canned Heat - On The Road Again
Cat Stevens - Wild World
David Bowie - Heroes
Depeche Mode - Enjoy The Silence
Dire Straits - Sultans of Swing
Eagles - Hotel California (Live Acoustic)
Elvis Presley - Jailhouse Rock
Eric Clapton - Layla
Europe - The Final Countdown
Guns And Roses - Knocking on heavens doors
Iggy Pop - The Passenger
INXS - Need You Tonight
John Lennon - Imagine
Kinks - You Really Got Me
Lou Reed - Walk On The Wild Side
Lynyrd skynyrd - Sweet home Alabama
Mamas And The Papas - California Dreaming
Metallica - Nothing Else Matters
Nirvana - Smells Like Teen Spirit
Oasis - Wonderwall
Offspring - Come Out And Play
Pink Floyd - Another Brick in the Wall
Pixies -  Where Is My Mind
Radiohead - Karma Police
Rage Against The Machine - Killing in the name
Red hot chili peppers - Under the bridge
Rem - Losing My Religion
Rolling Stones - Satisfaction
Run Dmc & Aerosmith - Walk This Way
Sex Pistols - God Save The Queen
Simon and Garfunkel - Mrs. Robinson
Steppenwolf - Born To Be Wild
The Clash - Should I Stay Or Go
The Cure - Boys Don't Cry
The Doors - Light My Fire
The Police - Roxanne
The White Stripes  - Seven Nation Army
The Who - My Generation
U2 - Sunday Bloody Sunday
