 http://www.nytimes.com/best-sellers-books/2012-05-20/combined-print-and-e-book-nonfiction/list.html

----

Support the authors you like.

Buy from stores without DRM.

----

List of books:


Bill O'Reilly & Martin Dugard - Killing Lincoln

Blaine Harden - Escape From Camp 14

Charles Duhigg - The Power of Habit

Cheryl Strayed - Wild

Clint Hill - Mrs. Kennedy and Me- An Intimate Memoir

Elizabeth Kaye - Lifeboat No. 8- An Untold Tale of Love

Erik Larson - In the Garden of Beasts

Hank Haney - The Big Miss- My Years Coaching Tiger Woods

Jenny Lawson - Let's Pretend This Never Happened

Jim DeFelice & Chris Kyle & Scott McEwen - American Sniper

Jonah Lehrer - Imagine- How Creativity Works

Jose Rodriguez - Hard Measures

Justin Halpern - Sh_t My Dad Says

Kim & Krickitt Carpenter & Dana Wilkerson - The Vow

Lady Colin Campbell - The Queen Mother

Laura Hillenbrand - Unbroken- A World War II Story of Survival, Resilience, and Redemption

Paul Krugman - End This Depression Now

Peter L. Bergen - Manhunt- The Ten-Year Search for Bin Laden

Rachel Maddow - Drift

Rebecca Skloot - The Immortal Life of Henrietta Lacks

Robert A. Caro - The Passage of Power - The Years of Lyndon Johnson

Steve Coll - Private Empire- ExxonMobil and American Power

Susan Cain - Quiet- The Power of Introverts in a World That Can't Stop Talking

Tina Fey - Bossypants

Todd Burpo & Lynn Vincent - Heaven is for real

Walter Isaacson - Steve Jobs