VA-Sleeping Buddha (40 Smooth Bar and Hotel Chillout Lounge Grooves for Easy Listening)-WEB-2012-JKoop

Artist     : VA
Album      : Sleeping Buddha (40 Smooth Bar and Hotel Chillout Lounge Grooves for Easy Listening)
Source     : WEB
Year       : 2012
Genre      : Chillout, Lounge, Easy Listening
Label      : Ragimusic
Encoder    : exact audio copy 0.96b
Codec      : lame 3.91
Quality    : CBR, 320kbps, joint stereo

Tracklisting

Skyfall - Particle of Soul
Milews - Cafe Del Mar Dreams - Buddha Bar Mix
Cocktail Groovers - Missing the Train - Dinner Night Lounge Mix
Monolounge Roudette - La Fleur De La Musique - Loca People Mix
Lemonjazz - Light Them All Up - Soul 2 Sax Mix
Swing Chill Transfer - Somewhere Between - Chill Lounge Air Bar Manhattan Mix
Sweet Velvet - La Plena Noche
Lounge Foyer - Perfect Day - Booty Swing Mix
Perelandra - Moon Over the City
Cape Town Chillerz - Sky in Your Eyes - Sunset Campari Chillout Hotel Bar Mix
Banghra Lounge Voices - Kamasutra in Heaven - Erotic Massage Mix
Deja 7 - One More Night - Summer Night Chill Mix
The Nightfly - Hope and Glory
Soleil Fisher - Beautiful Skies - Roxy Lounge Mix
Pathetique - Au Clair De La Lune - Vocal Lounge Mix
Cafe Del Chill - Sunset Beach of Love - Islands Chill Mix
Downtempo Groovers - Late At Night - Finger Pier Lounge Cafe Mix
Blue Lagoona - Follow Me
Aakarshan - Tantra Cafe - Sacred Spirit of Love Mix
Soleil Armada - When the Sun Goes Down - Big Chill On the Beach Mix
Bedroom Buddha - Mumbai Nights - Bar Cafe Mix
Melounge - Too Much Sugar - When Bedroom Love Takes Over Mix
Neo Soulz - My Love for You
KoolSax - Evasion - Nightingale Mix
DIMENTIA - You Don't Know - Vision of Love Mix
The Sheeran - Throwing All Away - Ed Van Harris Mix
Lea Perry - Dubby Sunset Sky At Cafe Del Mar
Merlion - Chillin Nightflight - Golden Buddha Sunset View Del Mar Mix
Taj Ravin - From India to Asia - Buddha Cafe Bar Zen Mix
Deechiller - City Lights - Soul 2 Sax Mix
Atrium - I See You - Beach Cafe Instrumental
Asia Suite Trio - Nine Books - Prism Sky Piano Mix
Red Metheny - New York City Nights - Summer Chill Lounge Mix
Stardust Alchemy - A Dream Under Your Star - After Dark Soleil Mix
Bangalore Masters - Satyam - Best of Buddha Bar Mix
Shakrag - Stardust Over Asia - Zen Cafe Garden Nightmix
Jazzonga - Run to Me - Cafe Groovera Hotel Mix
4tunes - October Shades
Sol 2 Sol - Cadillac - Backseat Love Affair Mix
Lotus Style Cult - Samota - Chop Suey Mix

Playing Time : 208:36
Total Size   : 478 MB
