192

Laidback Luke Ft. Angger Dimas - Night Like This (Instrumental Club Mix)

Lonny Bereal - Bedroom

Lonny Bereal - Man In His Spot

M To M – Fly High (Olympic Song)

Machel Montano - Going For Gold (2012 Olympic Games Soundtrack)

Marcus Canty - In & Out (feat. Wale)

Mariah Carey Ft. Rick Ross & Meek Mill - Triumphant (Get 'Em)

Matteo Sala - Believe Me (Matteo Sala & Lukas Mcs Original)

Melanie Amaro - Don't Fail Me Now

Memphis Bleek - Power Circle (Freestyle)

Michel Teló - Bara Bará Bere Berê

Mikkey Halsted Ft. Pusha T - Momma In My Ear

Muzzaik - Kontrast (Alex Gomez & Bias Factomania Pressure Remix)

Nelly Furtado -  Spirit Indestructible

Ne-Yo - Let Me Love You (Pulse Remix)

Nicky Romero Ft. Zedd & LIZ - Human (Original Mix)

Nightstylers - The Theme (Original Mix)

Niky Martinez - Ba Ba Baciami Piccina (Max.Si.Mas Dub Mix)

Nipsey Hussle - Tell Me What You Want

Pain & Rossini - Another Glass (Stefano Pain vs Marcel Remix)

Parade - Light Me Up

Pitbull Ft. Shakira - Get It Started (Jump Smokers Extended Mix)

Pixie Lott - Love You More

Porter Robinson - Language

R.I.O. - Miss Sunshine (Party vs. Stylez bootleg)

Reder - Sang The Songs (Luke DB Remix)

Roger Shah - Shine (Stefan Dabruck Remix)

Scumfrog - Don't Give Up (Steven Lee Remix)

Siege - Plug & Play (Sergio Fernandez Remix)

Simone Anes - Love Is A Battlefield (Falko Niestolik Mix)

Simone Vitullo - Shingalin (Original Intro Mix)

Sneaky Sound System - Friends (Norman Doray Remix)

Soulja Boy Ft. Neffi & Detail - Rollin Wet

Sterling Simms - Fumble

Stonebridge - Trees Against My Window (Album Mix)

Subscape -  Kick the Flow

T.I. - I Dont Like (Remix)

Takeshy Kurosawa - Let Me Go (Takeshy Kurosawa vs Maurizio Gubellini & Stefano Pain Main Mix)

Talib Kweli -  Push Thru

Three 'N One - Body Shine (Deejane Angel D & The Whiteliner Remix)

Tom Boxer And Keith Thompson - Nothing Compares To You (Radio Edit)
