Age Of Artemis - Take Me Home
Airya - Who Are We
Amberian Dawn - Cold Kiss
Ankor - Completely Frozen
Apsent - Sen Gercek Degilsin
Blessed By A Broken Heart ΓÇô Forever
Buddy Guy & Paul Rodgers - Some Kind Of Wonderful
Crucified Barbara - Heaven Or Hell
Dave Edmunds - The Wanderer
Eden's Curse - Time To Breathe
Foreigner - Growing Up The Hard Way
Free - Wishing Well
Hanging Doll - Carnival Of Sin
Headquakes - Come With Me ( If You Wanna Live )
Jason And The Scorchers - G╨╛lden Ball And Chain
Jeff Scott Soto - Look Inside Your Heart
John Cafferty & The Beaver Brown Band - On The Dark Side
Kissin Dynamite - My Religion
Leverage - Wolf And The Moon
Lordi & U.D.O. - They Only Come Out At Night
Lullacry - Bad Blood
Magic Kingdom - We Rise
Metal Church - Date With Poverty
Million Dollar Reload - Bullets In The Sky
Rata Muerta - Duros Como El Hormigon
Roger Daltrey & Bryan Adams - Let Me Down Easy
Savatage - One Child
Sister Sin - Sound Of The Underground
Skarlett Riot ΓÇô Villain
StoneTangier ΓÇô Stranded
Fury - Break Down The Walls
Ten - After The Love Has Gone
Theodore Ziras - Future Waves
Tora Tora ΓÇô Guilty
Tyketto ΓÇô Wings
V2 - Rock The City
White Wolf - She
