A La Carte - On Top Of Old Smokie
Accademia â€“ Dialogo
Ace Cats â€“ Linda
Air Supply - Making Love Out Of Nothing At All
Alice & Franco Battiato - I Treni Di Tozeur
Alison Moyet - Is This Love
Alvin Stardust - I Feel Like Buddy Holly
Arabesque - Sunrise In Your Eyes
B.Brink, I.Sheer, L.Valaitis & M.Roos - Twist â€“ Medley
Bayrische 7 - Der Ganz Normale Wahnsinn
Bernd Cluver - Der Junge Mit Der Mundharmonika
Blackmore's Night â€“ Journeyman
Captain Cook - Medley II
Chris Roberts - Do You Speak English
Danny & Armi - Loving You Only
Dorothee - Le College Des Coeurs Brises
Elsa - Quelque Chose Dans Mon Coeur
Gabor Presser  - A Szerelem Jo A Szerelem Faj
Gigliola Cinquetti - Il Condor
Howard Carpendale - Hello Again
Jimmy And The Mustangs â€“ Justine
Johnny Nash - I Can See Clearly Now
Nick Cave & Pj Harvey - Henry Lee
Nicole - Voulez-Vous Danser
Oscar Harris - Song For The Children
Oxana â€“ Lampenfieber
Patrick Lindner - Eviva Espana
Pia Zadora - Real Love
Pia Zadora - Rock It Out
Roland Kaiser - Manchmal Mochte Ich Schon Mit Dir
Rondo Veneziano â€“ Desiree
Tony Holiday - Tanze Samba Mit Mir
Vader Abraham - 't Smurfenlied
Village People - YMCA(Notte Disco Music)
Wirtschaftswunder - Manner Gibt's Wie Sand Am Meer
Wolfgang Petry - Wahnsinn

