Artista: VA
Titulo: VA - Absolute Club Autumn Vol 3 (2012)
Estilo: dance
Calidad: 320 kbps, 44100 Hz, Stereo
Tamaño: 673 Mb


VA - Absolute Club Autumn Vol 3 (2012)
A-Divizion, Joe Ghost - Zero Tolerance (Original mix)
Adam Doyle - Ronako (Original Mix) Crossborder Records
Ahllex - I Will Be There (Will Bailey Remix) Simma Records
Alex Greed, Matt Ace - Phosphor (Raw N Holgerson Remix)
Anton Neumark - Benghazi (Original Mix)
Anton Neumark - Underground (Inspired Souls Remix Russian Version)
Anton Neumark - Underground (Timer & Inkwell Remix) (Russian Version)
Anton Neumark, Johnny Beast - We Rock The Party (Techno Logic Remix)
Anton Neumark, P. Mauriat - Mamy Blue Star (Original Mix)
Boogie Pimps - 24Seven (Jolly Remix)
CCole - Go On (Marc Lener & Kilu Remix) Celebration
Cold Blank - Redroid (Original Mix)
Dafter - Up To Your Mind (Original Mix)
Dan Lemur - Get Down (Original Mix)
David Di Sabato - Orbits (Michele Calo Remix)
David Heat - Easy (Zero Gravity Remix)
Deenk & Home Alone - Run Around (Original Mix)
DisCo RoCk - Tokyo Anarchy In The Cellophane (Esteban Cors Remix)
Electroshock, DJ Neogame - Great Impression (Original Mix)
Emmanuel D Sotto - Club Diva (KillTheNeighbor Remix)
Freq Maverick - Batteries Not Included (Dubble JD Remix)
Fresh & Juicy - Anova (Original Mix) Dirt Lies & Audio Recordings
Gosteffects - Slave To The Sweat (Rule Of Eight Remix)
Groove Breaks - Tech Show (Sferlazzo Remix)
Jamie Berry, Rosie Harte - Paradise (Original Mix)
Jason Chance - Ready For It (Original Mix) Nocturnal Groove Digital
Johan K - Be With You (Club Mix)
Kevax - Keep Forgettin (Talstrasse 3-5 Remix) Aqualoop Records
Le Petit Belge & Le Cheval - Toronado (Original Mix)
Linkmindz - Chemical Dreamer (Original Mix) Metronix Recordings
Marc Vedo, Boy George, Desi Slava - Kalino Mome (Migue Soria remix)
Marcel Woods - Black Angus (Original mix)
Melfrez - Its Christmas (Original Mix) RIOT Records
Merlin Milles - Pump (Manuel Baccano Remix) Fuckin House
Miami Posh - Fk You All (Edlington Remix) Emun Music
Michael White - Secrets Of The Arpeggiator (Eric Farias Remix)
Misk, Arveene - Hells Bells (Tom Maddicott Remix)
Neon, DJ Sanny J, Ice M C - Alegria (Daniele Tek Mix) Sounds United
Paul Carpenter - Freaked Out (Club Extended)
Replug - Let’s Rock (Soulfix & Chi No Remix) Atomic Zoo Recordings (LE)
Riggers - Get The Crowd Hype (Original Mix)
Robert Maria Wolter - Contemplation (Original)
Savant - Fuck Nexus (Original Mix) SectionZ Records
Sharam Jey, Katrina Noorbergen - Living Like I’m Dying (Marco V Remix) King Kong Records
Smalltown DJs feat Alanna Stuart - Love Decoy (Top Billin Remix)
Sonny Black, Demon Groove - Crazy Glue (Original Mix) Big Alliance Records
Starpoppers - Vorwarts (Ric E. Vocal Mix)
Thorn - Gipsy (John Lemmon Remix)
Titus1 - Feel My Rhythm (Viro & Rob Analyze Remix)
Zombie Robot - This High (Original)

