**********************
******************
*************

Change (EXTENTION) to .RAR

Viral Electro 2012 - Martin db

Files, RAR = Mp3, Txt and Cover!

Cedric Gervais - Molly (Quintino Remix)	
Afrojack vs Skrillex - Rocking The Sweat (Ken Loi Edit)	
Vengeance - Three Days (Electrixx Remix)	
Matrick - Solaris (New Thomas & INTERNOS Remix)
Kaskade feat Haley - Llove (Dada Life Remix)
Mord Fustang - Sak Noel - Lick The Loca People (MS Bootleg)
Schoolboy - Aftershock	
Skrillex feat Members of The Doors  Breakn A Sweat (Zedd Remix)
Mord Fustang - Super Fever (Original Mix)
Zedd - Slam The Door (Rogue Remix)
Desinger Drugs - Throught The Prism (Dada Life Remix)
Excision - Skism - Sexism (Far Too Loud Remix)
Psy vs Zedd - Gangnam Style (Thorlacius ShaveUp)
Knife Party Vs Nicky Romero - Internet Iron Friends (Mashup)	
Swanky Tunes - Blood Rush (Original Mix)
Afrojack & R3hab - Prutataaa (Krafty Kuts Vocal Edit Re-Rub)
Clockwork - Titan (moiez Remix)
Savoy - Devils On Horseback
Angger Dimas - Resurrection (Original Mix)
Spencer Hill - James Brown Is Back (Club Mix)
Marco V - Analogital (Hard Rock Sofa Remix)
Wolfgang Gartner - Love & War (Original Mix)
Passenger 10 - Venue (Leventina Big Venue Remix)
Drivepilot - Vendetta (Original Mix)	
John Dahlback - Zeus (Original Mix)
Alex Mind - Facelift (Original Mix)	
Dada Life - Feed The Dada (Dyro Remix)	
Helvetic Nerds - Collum (Original Mix)	
Tristan Garner - Gregori Klosman Vs Laidback Luke Vs Daft Punk
We Are Prostitutez - Smash (We Are Prostitutez Remix)
Deadmau5 - Feed Me - Pixel Cheese (Skrillex Remix)
Swedish House Mafia Vs Marco - GOHA Antidote (DJ Trance MashUp)

Playtime:64min
KBPS 320
Recording - Compression - Denon Pro SSD Recorder
Gear:Pioneer CDJ 2000 - DJM 800 - Denon DNS 3700

Njoy

/Martin

mix.dj/SEvEN/medias
