PlayList

intro
Cut La Roc - New York Pimp
Wideboys & Sway (feat. McLean) - Shopaholic (FuntCase Remix)
Zeds Dead - Adrenalin
Snow Patrol - In The End (Whateverman Remix)
Bastille - Overjoyed (Distance Remix)
Wu-Tang Clan - Gravel Pit [Explicit]
Cracks (Flux Pavilion Remix) vs. Destination Calabria
chase and status - brixton_briefcase ft ceelo green
Underworld - Cups (Salt City Orchestra Mix)
Coolio vs Kylian Mash & Rico Bernasconi - Gangsta's Paradise 2010 (Doctor Werewolf Remix)
Alan Braxe and Fred Falke - Chrystal City
Dead Prez - Hip Hop [Explicit]
Moby - Go (Subliminal Mix)
chase and status - flashing lights ft sub focas and takura
Dead Prez & WTF! - It's Bigger Than Hip Hop (Dubbed Out Mix)
Groove Armada - At The River
Flux Pavilion - Internet Connection
Xilent - Choose Me (Dubstep Mix)
Gnarls Barkley - Crazy Dubstep
Dr. Dre Feat. Snoop Dogg - Nuthin' But A G Thang [Explicit]
DJ Fresh - Gold Dust (Flux Pavilion Remix)
Olive - You're Not Alone (Nightmares on Wax Mix)
Ice Cube - Ghetto Vet (Feat. Mac 10 & Mr. Short Khop)
NIN - La Mer
Space Raiders - Beautiful Crazy
The Prodigy - Breathe (Numbernin6 Remix)
Outkast - Ms. Jackson (Acapella)
Just Dont Give A F-ck (Acappella)
Skream & Example - Shot Yourself In The Foot Again
Example - Changed The Way You Kiss Me (Mensah Remix)
Nouvelle Vague - Teenage Kicks
Praise You - JFB Remix - Fatboy Slim and JFB
KOAN Sound - Trouble In The West
unkle - Tired of Sleeping
Jamiroquai - Blue Skies (Flux Pavilion Remix)
Gwen Stephani - Don't Speak Accapella
Space Raiders - Beautiful Crazy
outro