VA - Discazo Dance Remember Vol.4 (2012)

Categoria: Musica
Genero: Recopilatorios

Artista: VA
Titulo: Discazo Dance Remember Vol.4
Formato: Mp3
Tamaño: 512 Mb
Año: 2012


Lista de temas:

CD1

Gigi d Agostino - L Amour Toujours (Remix)
Prezioso Feat. Marvin - Let Me Stay
Imperio - Cyberdream
2 Unlimited - Tribal Dance
740 Boyz - Bump bump (Booty Shake)
Ann Lee - Voices
Billy More - Loneliness
Whigfield - Another Day
Dr Alban - Let The Beat Go On
Energy 52 - Café Del Mar
Gala - Suddenly
Kate Ryan - Desenchantee (Vocal Mix)
2 Fabiola - I m On Fire (Ultimate Radio Mix)
Komplot - Estas Loka
MC Sar & The Real Mc Coy - Runaway
Cappella - Move On Baby
Me & My - Dub I Dub
20 Fingers Feat. Katrina - Sex Machine
Rednex - Cotton Eye Joe
Sqeezer - Sweet Kisses
The Outhere Brothers - Pass The Toilet Paper
Twenty 4 Seven - We Are The World
Venga Boys- We Like To Party
Blumchen - Herz An Herz
Etc...etc...


CD2

2 Brothers On The 4th Floor - Can t Help Myself
Boyz-R-Us - Singin In My Mind
Flaix Project - Dance
Genova - Classics
Gigi D Agostino - The Riddle
Graphixx - Never Ending Story (Maxi-Mix)
Ice MC - Take Away The Colour
Kadoc - The Night Train
KLF - 3 Am Eternal
Maxx - No More (I can t Stand It)
Graphixx - Never Ending Story (Maxi-Mix)
Nightcrowlers - Push The Feeling On
ORGAN - To The World
Paradisio - Bailando
PG2 - Hey Hey Hey
Robin S - Luv For Luv
Rozalla - Are You Ready To Fly
Sly - One Day
Technotronic - This Beat Is Technotronic
The Grid - Swamp Thing
Taleesa - Let Me Be
The Traveller And In Motion - Believe (Key South Remix)
Tragic Error - Umbaba
The Jocker s - Cow Boy
Etc...etc...


CD3

Status - No More Pressure
Paraje - Animalaction
Joe Inferno - Tribal Church
Aladino - Brothers In The Space
Casseopaya - Overdose (Original Mix)
Da Blitz - Stay With Me
Digilove - Let The Night Take The Blame
Dj Hooligan - Sueño futuro (Wake Up And Dream)
Dream Frequency - Take Me
Fast Forward - Anonymous
Generis - Dreams
Gigi D Agostino - La Passion
Essential Feat. Allison - Touch The Sky
Gregory - World Of Dreams (Paramount Mix)
Head Trip - I Mean A... (Like A Criminal)
Jopan - Ghost
Mulhouse - Rave In The Jungle
Ozono - In The Mix
Quasimodo - I Need Loving You
Trax - Come Follow Me
Scooter - Hyper Hyper
Dsigual - Dsigual Vol. 1
Ex-3 - Extres
J & Zona Industrial - Demasiado