16 Bit Lolitas - Snake Inventer (Cut From Pit Set) (┬½ΓÇó┬╗)-enTc.mp3
Alex Mind - Glowsticks (Morttagua Remix) (Cut From Anderson Set)-enTc.mp3
Alex Mind - Glowsticks (Morttagua Remix) (Cut From Defcon Set)-enTc.mp3
Alexsy Ryasnyansky - Fly My Angel (Cut From Defcon Set)-enTc.mp3
Ana Criado & Omnia - No One Home (ASOT 571 Rip)-enTc.mp3
Araya - Purity (Blugazer Remix) (Cut From Anderson Set) (┬½ΓÇó┬╗)-enTc.mp3
Arctic Moon - Starships Over Alice (ASOT 571 Rip)-enTc.mp3
Artur Akopov - CanΓÇÖt Wait (Original Mix) (Cut From Anderson Set)-enTc.mp3
Ashley Wallbridge feat. Elleah - Keep The Fire (Sean Tyas Reminder Remix) (ASOT 571 Rip)-enTc.mp3
Boxer & Forbes - Getting Closer (Hanski Remix) (Cut From Anderson Set)-enTc.mp3
Bvibes - Down Force (Cut From Pit Set)-enTc.mp3
Chris Ride - Strobe (Original Mix) (Cut From Anderson Set)-enTc.mp3
Danny Stubbs - Waiting For The Horizon (Eximinds Remix) (Cut From Anderson Set)-enTc.mp3
Digital Citi Zen - Tranquility (Cut From Defcon Set)-enTc.mp3
DJ Roman Max - One Dream (Cut From Defcon Set)-enTc.mp3
Dmitry Strochenko & Denis Karpinsky - Everest (Cut From Defcon Set)-enTc.mp3
Ernesto vs. Bastian - Who's The Starter 2012 (ASOT 571 Rip)-enTc.mp3
Fashion Police & Witness45 - Balearia (Club Mix) (Cut From Anderson Set)-enTc.mp3
Garrido & Skehan Feat. Erin - Throw It All Away (Original Mix) (Cut From Anderson Set)-enTc.mp3
Gotye - Somebody I Used To Know (Sulaco Remix) (Cut From Defcon Set)-enTc.mp3
Hanski Feat. Ren - Too Far (Original Mix) (Cut From Anderson Set) (┬½ΓÇó┬╗)-enTc.mp3
Hanski featuring Ren - Too Far (Cut From Defcon Set)-enTc.mp3
Matson - Subway (Original Mix) (Cut From Anderson Set)-enTc.mp3
Mike Sonar feat. Anthya - Anytime (Mike Sonar Remix) (Cut From Anderson Set)-enTc.mp3
Myk Bee - Green Lights (Original Mix) (Cut From Anderson Set)-enTc.mp3
Orjan Nilsen - Phireworks (ASOT 571 Rip)-enTc.mp3
Poshout - Jumeiriah (ASOT 571 Rip)-enTc.mp3
Rebels Without A Cause - Compuphonic (Club Mix) (Cut From Pit Set)-enTc.mp3
ReOrder - Every Other Day (Eximinds Remix) (ASOT 571 Rip)-enTc.mp3
Ron Hagen & Al-Exander - Accentus (ASOT 571 Rip)-enTc.mp3
Sou Kanai - Oriental Wind (North State & Roby K Remix) (Cut From Anderson Set)-enTc.mp3
Sou Kanai - Oriental Wind (North State & Roby K Remix) (Cut From Pit Set) (┬½ΓÇó┬╗)-enTc.mp3
T.O.M. - Norderney (PhyGer Remix) (Cut From Anderson Set) (┬½ΓÇó┬╗)-enTc.mp3
Tenishia & Ruben de Ronde feat. Shannon Hurley - Love Survives (ASOT 571 Rip)-enTc.mp3
Tenishia - Point Of No Return (ASOT 571 Rip)-enTc.mp3
Up & Forward - Aquamarine (Dallaz Project Remix) (ASOT 571 Rip)-enTc.mp3
Up & Forward - Aquamarine (Original Mix) (Cut From Anderson Set)-enTc.mp3
Vasiliy Goodkov - Cote D'Azur (Cut From Defcon Set)-enTc.mp3
Wellenrausch - Tonight (Danilo Ercole Remix) (Cut From Ercole Set)-enTc.mp3
X-33 featuring Stephanie Kay - Candy (Cut From Defcon Set)-enTc.mp3
