

All You Need Is Love-The Best of(2012)MP3 Nlt-release


Tracklist:


Disk 1
Alexis Jordan - Happiness
Gotye ft. Kimbra - Somebody That I Used To Know
Coldplay - The Scientist
Lady Antebellum - Need You Now
John Mayer - Heartbreak Warfare
Laura Jansen - Use Somebody
Train - Hey, Soul Sister
Caro Emerald - A Night Like This
Racoon - Love You More
Anouk - I'm A ClichÃ©
John Lennon - Woman
BlÃ¸f - Liefs uit Londen
Alicia Keys - Empire State of Mind (Part II)
Justin Timberlake - Cry Me A River
Maria Mena - All This Time (Pick-Me-Up Song)
Mads Langer - You're Not Alone
Nelly Furtado - Say It Right
Lenny Kravitz - I'll Be Waiting
Katy Perry - Firework
Sabrina Starke - Do For Love

Disk 2
Whitney Houston - I Will Always Love You
Maroon 5 - She Will Be Loved
Sara Bareilles - Love Song
Simon Webbe - No Worries
Leona Lewis - Bleeding Love
Ben Saunders - When A Man Loves A Woman
Christina Aguilera - Beautiful
Guus Meeuwis - Ik ook van jou
Glennis Grace - Always
John Legend - Ordinary People
Dido - Thank You
Di-Rect - Hold On
Blue - One Love
Jeroen van der Boom & Leonie Meijer - Los van de grond
Racoon - 2014
Trijntje Oosterhuis - See You As I Do
Gavin DeGraw - Not Over You
BlÃ¸f - Alles is liefde
Joshua Radin - Only You
Hurts - Stay

Disk 3
Sade - No Ordinary Love
City to City - The Road Ahead
Kate Winslet - What If
Caro Emerald - The Other Woman
Dazzled Kid - Embrace
Gabriella Cilmi - Sweet About Me
Santana ft. The Product G&B - Maria Maria
Colbie Caillat - Bubbly
Lisa Lois - Hallelujah
Dotan - Where We Belong
Atomic Kitten - Eternal Flame
Joe Cocker & Jennifer Warnes - Up Where We Belong
Sugababes - Too Lost in You
Jeroen van der Boom - Werd de tijd maar teruggedraaid
Krezip - I Would Stay
Miss Montreal - Just A Flirt
The Commodores - Easy
RenÃ© Froger - 'k Heb je lief
Melanie C - I Turn To You
The Wanted - Glad You Came 


Postinfo:

Category : Sound 
  Format : MP3 
  Source : CD  
  Bitrate : 320kbit  
  Genre : Diversen  
  Tag(s) : NLT

Enjoy,

NLT_RELEASE  IS WEER TERUG KOM SNEL NAAR:
 
http://www.nlt-release.nl

By Hopy
