 http://i.imgur.com/5gzl8.jpg

Caro Emerald Presents: Drum Rolls & Heartbreaks

Deze 2cd compilatie vertelt het verhaal achter het succesalbum Deleted Scenes From The Cutting Room Floor van Caro Emerald. In 34 tracks nemen Caro en haar producers de luisteraar mee naar de inspiratiebron van haar eigen sound: geweldige artiesten en liedjes uit 30's - 50's die het niet verdienen om vergeten te worden. Luister naar prachtige liedjes van o.a. Dean Martin, Shirley Bassey, Sarah Vaughan, Doris Day en Billie Holiday maar ook minder bekende artiesten als Luis Arcaraz, Lina Romay en Xavier Cugat.
Speciaal voor de fans: als bonus bevat deze compilatie een speciale, geheel in jaren '40 stijl opgenomen akoestische uitvoering van 'Dream A Little Dream Of Me' door Caro zelf.
Tracklist
Disk 1 
1. Jimmy Dorsey And His Orchestra W. Helen O'connell – Man, That's Groovy 
2. Gene Krupa - Drum Boogie 
3. Stan Kenton & Anita O’Day – And Her Tears Flowed Like Wine 
4. Xavier Cugat – Green Eyes 
5. Edmundo Ros & His Orchestra - Sorta On The Border 
6. Enric Madriguera - One Night In Brazil 
7. Andrew Sisters (With Bing Crosby) - Pistol Packin' Mama 
8. The De Castro Sisters - Teach Me Tonight Cha Cha 
9. Dean Martin – Sway 
10. Shirley Bassey - Kiss Me Honey Honey (Kiss Me) 
11. Della Reese – Why Don't You Do Right 
12. Jack Costanzo – I Love Paris 
13. Perez Prado - Mambo Nº 5 (Live) 
14. Les Brown And His Orchestra - I Got The Sun In The Morning 
15. Tex Williams - Smoke Smoke Smoke (That Cigarette) 
16. Eartha Kitt - Mambo De Paree 
17. Andrew Sisters - Aurora 

Disk 2 
1. June Christy – It’S Been A Long Time 
2. Sarah Vaughan - Whatever Lola Wants 
3. Doris Day With Les Brown – Sooner Or Later 
4. Fats Waller - Your Feet's Too Big 
5. Billie Holiday – Pennies From Heaven 
6. Django Reinhardt & Jean Sablon - Darling, Je Vous Aime Beaucoup 
7. Luis Arcaráz - Viajera 
8. Martin Denny – Martinique 
9. The Boswell Sisters - Heebie Jeebies 
10. Xavier Cugat And Dina Shore – The Breeze And I 
11. Andrews Sisters - Toolie Oolie Doolie 
12. Eartha Kitt - My Heart Belongs To Daddy 
13. The Dinning Sisters - You're A Character Dear 
14. Lina Romay - Don't Get Around Much Anymore 
15. Les Baxter - Adios 
16. Chick Webb W. Ella Fitzgerald - You’Re Gonna Loose Your Gal 
17. Caro Emerald - Dream A Little Dream Of Me 


Source: CD, Catweasel
Bitrate: 320Kbs
Genre: Jazz

Including HD COVERS

FRONT, BACK AND CD


Njoy!
