Landerz BassGiving Mix (November 2012)  320kbps  78min  (HAPPY THANKSGIVING!!)

Lil Jon - Snap Your Fingers (Candyland Remix)
Flosstradamus - Twark
Yung Joc - Goin Down (Milo & Otis Remix)
Filthy Disco - Rollin
Alex Young - Relapse (Hydraulix Remix)
Bro Safari ft Notorious B.I.G. - Scumbag
Bro Safari - That Ass
Baauer - Harlem Shake
Spenca - Riverside (Spenca OG Trap Remix)
Skrillex ft Damian Marley - Make It Bun Dem (Notixx Remix)
Sam Roberts Band - Let It In (Grandtheft Remix)
Diplo - Horsey (Lazrdisk Party Sex Remix)
Goodzie - The Storm
Goodzie - Remember The Madness
Dillon Francis - Bootleg Fireworks Burning Up
Must Die! - Wheels Theme (Dirt Monkey Remix)
Rusko - Like This
Flux Pavilion - Bass Cannon (Lost Boys Remix)
Maadman - Rude Boy 
Monsta - Where Did I Go (Dillon Francis Remix)
SkisM - Experts (xKore Remix)
SkisM - Experts
501 - Smash!
MSD & Jillian Ann - Quiet Riot (Pegboard Nerds Remix)
Tiesto & Steve Aoki - Tornado (Kill The Noise Remix)
Fabio Lendrum - Out Of The Water (501 Remix)
Elonious - Phobia
Total Recall - Dosage (Cyberoptics Remix)
Tmare - Coloring Book (Skullee Remix)
Zomboy - Jam On It
Doctor P ft Eva Simmons - Bulletproof
Jantsen & Dirt Monkey - In The Mood
Dirt Monkey - Boom Bam
Must Die! - Hold Me Now
Two Fingers - Vengeance Rhythm (KOAN Sound Remix)
Crucia & Do Or Die - Yandere Lovin
Krewella - Alive (MitiS Remix)
Dirtyphonics - Dirty (Synchronice Remix)