Światowy literacki bestseller w formie audiobooka. Gwiazdorska obsada.
Specjalne efekty dźwiękowe i ponad dwie godziny muzyki!

Szlachetne rody zamieszkujące Zachodnie Krainy walczą o władzę. W grze o Żelazny Tron wygrywasz albo umierasz.

Adaptacja kultowej epopei George'a R.R. Martina, wydanej nakładem Zysk i S-ka Wydawnictwa, to produkcja niemająca sobie równych.

Obsada:  
Asińska Weronika – Sansa Stark
Banaszyk Krzysztof – Narrator
Benoit Mariusz – Maester Pycelle
Boberek Jarosław – Khal Drogo
Bondyra Piotr – Robb Stark
Braciak Jacek – Tyrion Lannister
Bychawska Pola – Arya Stark
Dereszowska Anna – Lysa Stark
Dracz Krzysztof – Lord Varys
Dziędziel Marian – Król Robert Baratheon
Garlicki Łukasz – Renly Baratheon
Gonera Robert – Jorah Mormont
Juchniewicz Marcin – Sandor Clegane
Kuduk Dorota – Daenerys Targaryen
Kulec Damian – Jon Snow
Kulesza Agata – Catelyn Stark
Łotocki Lech  - Selmy Baratheon
Mohr Rafał – Littlefinger
Musiał Maciej – Joffrey Baratheon
Orzechowski Sławomir – Lord Dowódca Mormont
Pławiak Filip – Viserys Targaryen
Seweryn Maria – Cersei Lannister
Simlat Łukasz - Jaime Lannister
Więckiewicz Robert – Eddard Stark
Wojciechowski Mariusz – Tywin Lannister
i inni.