2 Chainz Ft. Nicki Minaj - I Luve Dem Strippers
Aaliyah Feat Drake - Enough Said
Ace Hood Feat Bun B & Kirko Bangz - Double Cup
Aiden Grimshaw - Curtain Call
Azealia Banks - Succubi (Jim Jones Dis)
Beenie Man - Clean Like This
Belly Ft. Snoop Dogg & Gunplay - I Drink I Smoke (Remix)
Black Eyed Peas - G.r.a.p.e.s ( Single Version)
Chicane - Where Do I Start ( Original Mix )
Chris Reece & Jennifer - Never Let Me Go ( Extended Mix)
DJ Khaled Ft. Nas, Scarface & DJ Premier - Hip Hop
Eastside Jody Ft. Pusha T - Ready To Go
Ellie Goulding - Anything Could Happen
GABE - Under The Lights
GABE Ft. Chrishan - Weakness Of The Body
Guy Sebastian ft Lupe Fiasco - Battle Scars
Honey Cocaine - Young Dreamer
Hoobastank - No Destination
Inna - Crazy Sexy Wild
Jack Beats Ft. Diplo & Example - War
Jeremih Ft. Gucci Mane & 2 Chainz - Outta Control
Jimmie Reign - She Loves
John Dahlback - Blink  (Chris Remix)
JoJo - Anything ( Robson Michel Extended Version )
Jori King - You Need Me
Kat Deluna Feat El Cata - Sobredosis
Kelly Rowland - Down For Whatever (Max Sanna Radio Mix)
Kirko Bangz Ft. French Montana - Walk On Green
Lawson - Let Go
Lawson - Taking Over Me (Acoustic Version)
Leftside - Johnny Bravo
Loick Essien ft Dawn Richard - All Around The World
Mac Miller & Pharrell - Glow
Machel Montano Ft. Beenie Man - Champion
Melanie Amaro - Don't Fail Me Now
Nelly Feat Chris Brown - Marry Go Round
Pixie Lott - Love You More
PJ Morton Ft. Lil Wayne - Lover
Qwote Ft. Pitbull - Letting Go
Rita Ora - Radioactive
Rita Ora - What Makes You Beautiful (One Direction Cover)
Rob G Ft. Chamillionaire - Paper Plates
Sammie - Next Breath
Sean Kingston ft Meital - On Ya
Shontelle - Custom Made
Sizzla - Want It Again
Skrillex - My Goodbye
Slaughterhouse - Goodbye
Slaughterhouse - See Dead People
Steve Aoki & Angger Dimas feat. Iggy Azaela - Beat Down
Taylor Swift - Both of Us (Solo Version)
The xx - Angels
Trae The Truth Ft. Z Ro, Kirko Bangz, Bun B, Slim Thug & Paul Wall - I'm From Texas
Trey Songz - Eat It Up (Trigga Remix) (LoveRance Cover)
Tyga Feat 2 Chainz - Do My Dance
Vybz Kartel - Dem Bwoy
XV - Rise