52 Top bollywood Video Item Songs, most in High Definition..

Praise if Like!!!




i.	AAG - Mehooba Mehbooba 
ii.	Aapka Kya Hoga (Dhanno) - Housefull (2010) -HD- 1080p -BluRay- Full Video Song 
iii.	AB TO FOREVER -┬íCHICA CHICA! ┬íESA ES MI CHICA - HD 
iv.	Agent Vinod (2012) - Pyaar Ki Pungi Full Official Video Song 
v.	Anarkali Disco Chali -HD 
vi.	Aye Ganpat Chal Daru Laa 
vii.	Aye Hip Hopper - ishQ Bector [OFFICIAL HD VIDEO] 
viii.	Bachna Ae Haseeno [Full Song] (HD) W_ Lyrics + English Translation - Bachna Ae Haseeno 
ix.	Badan pe sitare 
x.	Channo Veena Malik Full Song - Gali Gali Chor Hai 
xi.	CHAR BAJ GAYE (F.A.L.T.U) 1080P HD 
xii.	Character Dheela-Ready 2011 Full Song [HD] 
xiii.	Chiggy Wiggy - Blue (2009) -BluRay- Music Videos 
xiv.	Chikni Chameli - (Official Full HD Video Song) Ft.Katrina Kaif 
xv.	Dakku Daddy - ishQ Bector [OFFICIAL HD VIDEO] 
xvi.	Dan Dan Cheeni - Department 
xvii.	Darling - 7 Khoon Maaf (2011) -HD- 1080p -BluRay- Music Video - YouTube.webm
xviii.	De Do Dil De Do Dil Ka Achar Dalogi ( Full Song Mirani Bhai ) Bin Bulaye Baarati 2011 HD 
xix.	Dil Me Baji Guitar (Apna Sapna Money Money) Karaoke Singing Cover by Rahul 
xx.	'Do dhari talwar' new full song from Mere brother ki dulhan by akfunworld.avi 
xxi.	Gustakh Nigah 1080p HD Gustakh Nigaah full Song HD 
xxii.	I Hate Luv Storys Title Full Song - I Hate Luv Storys (2010) -HD- 1080p Video Song 
xxiii.	Ishq Barse Full Song - Raajneeti 
xxiv.	Jalebi Bai - -Double Dhamaal (2011) -HD- 1080p Full Video Song - Hot Mallika Sherawat 
xxv.	Jhoom Barabar Jhoom (Amitabh Bachchan) - Jhoom Barabar Jhoom 
xxvi.	Kameeni tera Bhut Char Gaya-rakhi Sawant 
xxvii.	Karle Gunah HD From Ugly aur Pagli HQ 
xxviii.	Laaga Chunari Mein Daag - Kachchi Kaliyaan _ German Subtitle _ [2007] 
xxix.	Laial o laila-Blu-ray, Full HD, 1080 P, 720 P, 16-9 Ratio, DVD Rip 
xxx.	laila o laila 
xxxi.	Laung da lashkara- (Official full song) -Patiala House- Feat. Akshay Kumar 
xxxii.	Lazy Lamhe - Song - Thoda Pyaar Thoda Magic - YouTube_2.mp4
xxxiii.	Le-Le-Maza-Le-Maza-Wanted-Hindi-Movie-SonG 
xxxiv.	Love Me Love Me - Wanted 1080p 
xxxv.	Mayya Mayya -GURU HD 
xxxvi.	Mehbooba Mehbooba- (Sholay) 
xxxvii.	Mere Yaar -BluRay- - Shootout At Lokhandwala (2007) - Full Song - Music Video 
xxxviii. Mit Jaaye Gham - Full Video Song (Dum Maro Dum 2011) - Deepika Padukone 
xxxix.	Munni Badnaam Hui - Dabangg (1080p HD Song) 
xl.	Naino Wali Whiskey Full Song HD 
xli.	Razia (Full Song) - Thank You (2011) -HD- 1080p -BluRay- Music Video 
xlii.	Saaki - musafir Sexy Bellydance 
xliii.	Saaki Saaki Full Song - Musafir - Sanjay Dutt - Koena Mitra 
xliv.	Shalu Ke Thumke - - HD - HQ - Full Song - 
xlv.	Sheila Ki Jawani - Tees Maar Khan (2010) -HD- 1080p Video Song 
xlvi.	Stereo Nation (Full Song) - Hai Hai Jawani (Exclusive) HQ 
xlvii.	Subha Hone Na De Full Song- - Desi Boyz - Akshay Kumar - John Abraham 
xlviii.	Tandoori Nights (Full Song) Film - Karzzzz 
xlix.	Ticket To Hollywood - Full Song - Jhoom Barabar Jhoom 
l.	Tose Pyaar - Wanted (2009) 
li.	Uncha Lamba Kad fHD Quality - 1080i-720p frm A2B -) 
lii.	(HD) Malaika Arora - SONE KE JAISI HAI MERI JAWANI 



CHEERS :-)

Abro, Fahad

abrofahad@hotmail.com