Dodge & Fuski - Got 2 Come Together
AN21 & Max Vangeli vs. Steve Angello - H8RS (David Heartbreak & Alexandre Remix)
Fatboy Slim - The Rockafeller Skank (Sketi 2012 Breaks Edit)
Alex Clair - Too Close (Klever Remix)
Deorro AKA TON!C - BIG FAT (Party Favor's Big Re-Fix)
Big Makk - Hold On To Trap
Borgore - Decisions (Blitz Gang Remix)
Brokencyde-Magnum  feat. Mickey Avalon
Sandro Silva & Quintino - Epic (Luminox Remix)
Epic Blowup (Party Favor's 'Booty Pop' Bootleg)
Exceed - Ditty Ditty (Original Mix)
Excision & Savvy - Sleepless (Xilent Remix)
OG Status - Gangster Music
Birdy Nam Nam vs Driicky Grahm - Goin' In with Snapbacks & Tattoos (DOOBI & DURD3N Mashup)
Hassasin - Orchestrated Nightmare (Blitz Gang Remix)
In For The Kill - (La Roux)DJ Slinks Get Trappy Remix
Kanye West - Mercy (RL Grime & Salva Remix)
Kill The Noise - Roots (Brillz Remix)
KillaGraham - Clowns (Original Mix)
KOAN Sound - Sly Fox (Davip Beats Edit)
Lil Troy - Wanna Be A Baller (Structure Rmx)
David Guetta - Love is Gone (Love is Trap) (Serafin Trap Remix)
Skrillex - Make It Bun Dem (Party Favor's '4 Alarm Fire' Remix) 
Meek Mill feat Drake - Amen (Mighty Mi & Slugworth Trap Mix)
Nero - Promises (Ray Complex Remix)
Dream Mclean - Network (Chase & Status Remix) 
OG Status - Seven Figures
Swedish House Mafia - ONE (Party Favor's Festival Trap Mix)
Detzky - Peanut Butter Jelly Time (Trap Version)
ready for the world - love you down (exceed remix)
Awol Nation - Sail - DJ Slink Remix
Structured Noises - Darkstep Warrior
Wick-it The Instigator - The Golden Trap Gangster
TiÃ«sto feat. Kay - Work Hard, Play Hard (HBREAKER Remix)
Laidback Luke & Steve Akoi ft Lil Jon - Turbulence (Oh Snap!! Trap Mix)
Vital Techniques & Mikey B - Not Gonna Get Us
Katty Perry - Wide Awake (Rydall Remix)
Zeds Dead - Cowboy (Young Mush TRAP$TEP rmx)