Sunshine Live - Classics (2012-09-29)

*commercials and news removed*

Bit-Rate: 200-250 kbit/s VBR
Samplerate: 48000 Hz
Runtime: 3:12:42


Playlist: 
http://www.sunshine-live.de/onair/  (select: 29.09.2012 09:00 Uhr)

Nalin I.N.C. - Planet Violet
Jimmy Tenor - Take Me Baby
New Order - Confusion (Extended mix)
Paul Van Dyk - For An Angel
La Voix - The Sunrise
usura - open your mind
ATB - Don´t Stop (ATB Remix)
Sylver - Turn The Tide
Gigi d´ Agostino - Bla Bla Bla
Dr. Motte und Westbam - Sunshine (Loveparade 97)
B.B.E. - Flash (Original mix)
storm - stormanimal (club mix)
Intrance ft.D-Sign - Te Quierro (Original Mix)
Hypetraxx - The Darkside
blank & jones - the nightfly
Aquagen - Ihr seid so leise (Wie früher Mix)
Jordan & Baker - Explode (Marc van Linden Remix)
alcazar - crying at the discothek
System F - Dance Valley Theme 2001
ron van den beuken - timeless (R.v.d.Beuken Rmx)
Marc Van Linden - Sturm Der Nacht (Nur Für Dich)
DJ Quicksilver - Bellissima
K.K. Project - Everything Counts
Perplexer - church of House (Heaven & Hell Mix)
RMB - Redemption
Mark`Oh - randy (Never Stop that feeling)
dune - i can´t stop raving
Sash! - Encore Une Fois
Kosmonova - Dance avec moi! (Extended Mix)
Alice Deejay - Back In My Life (Extended Vocal)
Lasgo - Something
delerium - silence (Tiestos-In Search of Sunrise Remix)
darude - sandstorm
Tillmann Uhrmacher - On the run (Ocean to shore Club Mix)
faithless - insomnia (Monster Mix)
Nalin & Kane - Beachball
Underworld - Born Slippy (Nuxx)


 
http://www.sunshine-live.de/onair/dj-music/classics/