192
Afrojack - Rock the House (Dirty Dutch Visionaire Remix)

Alex Sayz - Free To Go (Stefano Noferini Club Mix)

Allen S - Full Room (Main Mix)

Andrea Bertolini - Drop That Beat (Original Mix)

Antonique Smith - Speechless

Aubrey ODay - Somebody That I Used Know (Remix)

Avicii vs Deniz Koyu - Bong Into Darkness (Hardwell & Dannic MashUp)

Avicii vs KOT - Finally the last Dance (eSQUIRE Mashup)

Benny Benassi ft. Gary Go vs Firebeatz - Cineman (Hardwell MashUp)

Cash Out - Big Booty

Chris Webby Feat Kid Ink & Bun B - Wait A Minute

Chrishan - That's Just Life 

Coolio - It Takes A Thief (Angel Anx Tested Remix)

Cory Gunz - Stacks On Deck

Cygnus X vs David Guetta & Nicky Romero - Super Metropolis (Hardwell MashUp)

David Archuleta - Broken

David Guetta & Sia vs Qulinez & Sick Individuals - Trolltanium (Hardwell MashUp)

David Jones - Stand Up (Club Mix)

Dean Raven - Addiction

Delphic - Good Life

Dimitri Vegas & Like Mike & The WAVs Ft. Kelis - Changed Today (Tomorrowland Anthem 2012)

DJ Eako & Peppe Nastri - Stupid Game (Stefano Pain vs Marcel Booty Mix)

DMX vs Clockwork - Squad Up In Here (Hardwell & Dannic MashUp)

Ellie Goulding - Hanging On (Pink Panda Remix)

Ellie Goulding - Hanging On (Sound Remedy Remix)

Emeli Sandé - Daddy (Promise Land Remix)

Emma Hewitt - Miss You Paradise (Beckwith Remix)

Example - Say Nothing

FloRida & LMFAO - Run ( US Version)

Gabriel & Dresden - No Reservations (Original Mix)

Gary Caos - Specialize In Love (Club Mix)

Granite & Phunk - One & Only (Nathan Detroit Vocal Mix)

Gym Class Heroes (feat. Ryan Tedder) -  The Fighter

ItaloBrothers - My Life Is A Party (R.I.O. Video Edit)

J. Cole - The Cure

Jason Aldean -  Take a Little Ride

Jason Derulo - In My Head (Tiziano Deiana Summer Remix 2k12)

Javiunder - Get It Right (Original Mix)

Jim Johnston - Somebody Call My Momma (Brodus Clay)

K Young Ft. Ya Boy - Something Different

Keane - Sovereign Light Café

Kelly Rowland Feat Lil' Wayne - Ice (Radio Version)

Kendrick Lamar -  Swimming Pools (Drank)

Khaled - C'est La Vie