
Alex Gaudino feat. Taboo - I Dont Wanna Dance (radio edit)
Alex Goot - Lights
Avant Feat KeKe Wyatt - You & I
Billy Ray Cyrus - Change My Mind (Radio Edit)
Bob Sinclar - Groupie
Bobby Debarge Jr. - One And Only
Carly Rae Jepsen - This Kiss
Cassie Feat Young Jeezy - Balcony
Cee Lo Green - Blitzkrieg Bop (I Love Football)
Cheesa - I'm Not Perfect (feat. Charice)
Chiddy Bang - Mind Your Manners (Feat. Icona Pop)
Christina Aguilera - Your Body (Radio Edit)
Conor Maynard Feat Ne-Yo - Turn Around (Radio Edit)
Dappy - Good Intentions
David Guetta (feat. Ne-Yo And  Akon) - Play Hard (Album Version)
Dom Kennedy - My Type Of Party
Elise Estrada - Piece Of Me
Example - Say Nothing (Radio Edit)
Faith Evans - Dumb
G&G feat. Gary Wright & Baby Brown - My My My (Coming Apart) 2K12 (Radio Edit)
Lil Wayne  (feat. Detail) - No Worries
Marc Anthony - Cautivo De Este Amor
Matchbox Twenty - She's So Mean (Ralphi Rosario Radio Mix)
Meek Mill (feat. Big Sean) - Burn 
Miguel - Do You
Missy Elliott With Timbaland - 9th Inning
Missy Elliott With Timbaland - Triple Threat
Moker - J'trace Ma Route
Nicki Minaj & Cassie - The Boys
Noisettes - That Girl
Of Monsters and Men - Little Talks
Otto Knows - Million Voices (Original Mix)
Pablo Alboran - Tanto
Paty Cantú - Corazón Bipolar
Pip - Who Cares
Professor Green - Avalon (Kat Krazy Radio Edit)
Robbie Williams - Candy
Ryan Leslie Feat Fabolous - Beautiful Lie (Remix)
Samsaya - Good With The Bad
Sean Paul Feat DJ Ammo - Touch The Sky
Soulja Boy Tell 'Em - Let's Get It
Stella Mwangi -  Stella, Stella, Stella
Xzibit - Up Out the Way
Zaho - Boloss
