Sunshine Live - Classics (2012-07-21)

*commercials and news removed*

Bit-Rate: 200-250 kbit/s VBR
Samplerate: 48000 Hz
Runtime: 3:18:18


Playlist: 
http://www.sunshine-live.de/onair/  (select: 21.07.2012 09:00 Uhr)

Motorcycle - As The Rush Comes
Dido - Sand In My Shoes [Above & Beyond Remix]
frankie goes to hollywood - the power of love (rob searle remix)
Diver & Ace - Mental Thing [Phase II Mix]
Peter Fly - Oriental Dream
Mauro Picotto - Lizard
Kasai - Passion
M.U.T.E. pres. Dedicato - Dedicato
Cerf, Mitiska & Jaren - You Never Said (Dash Berlin Remix)
Deepest Blue - Shooting Star (Smith & Pledger Remix)
Sureno - Guideline
Nickelson - Yin
Ernesto vs. Bastian - Dark side of the moon
Crazy Malamute - Free To Ride
blue alphabet - cybertrance
3 Phase feat. Dr.Motte - Der Klang der Familie
Montini Experience meets Cygnus X - My Orange Theme Is Your Orange Theme (And Your Klang Is Der Familie)
Odyssee Of Montini - Firedance - Sunrise im My & Your House [Diggerman Mischt alles durch Mix]
Members Of Mayday - we are different
Scooter - Unity Without Words Part I
RMB - Reality
Moby - Feeling So Real [Westbam Remix]
DJ Yanni & The Paragod - Initialize
Klangwerk - Die Kybernauten
abfahrt - alone (it┬┤s me)
Out of the Ordinary - Play it again (Los Ninos Mix)
Kraftwerk - Das Model (12┬┤┬┤ Mix)


 
http://www.sunshine-live.de/onair/dj-music/classics/