Landez EDM All-Star Mix 2012  80min  320kbps

(TRAP)
Bassnectar - Vava Voom (feat. Lupe Fiasco)
Notixx - The Most Fresh
MIA - Bad Girls (Danny Grooves Remix)
Oh Snap - Samir In the Trap
Birdy Nam Nam - Goin' In (Skrillex Goin' Down Mix)
Benny Benassi - Satisfaction (Mr.Vandal's Trapisfaction Remix)
Coolio - Gangsters Paradise (Candyland's OG Remix)
Dillon Francis - Masta Blasta (THE REBIRTH)

(MOOMBAHTON)
Dillon Francis & Kill The Noise - Dill The Noise
Timetakers - She Blows (Whistle Tune) (Dillon Francis Remix)
Bro Safari - Da Worm
Bro Safari - Uncrushable 
Toddla T - Body Good (Thee Mike B's Massive Edit)
Lil' Wayne - Motivation (gLAdiator Remix) 
Dillon Francis & Doctor P - Music Is Dead
DFace - Mad Man (Aylen Remix)
 
(ELECTRO HOUSE)
Zedd - Slam The Door
Labrinth ΓÇô Last Time (Knife Party Remix)
Feed Me - One Click Headshot
Klaypex - Crazy
Klaypex - Sunrise feat. Sara Kay
Dillon Francis - IDGAFOS 2.0
Nishin Verdiano & AK9 - Bitch Please
Street Lurkin, Anna Yvette - Hold Your Breath (Dirt Monkey Remix)

(DUBSTEP)
Knife Party - Bonfire
J.Rabbit - Bad Larry
Zeds Dead - Crank
Skrillex - Bangarang feat. Sirah
Kill The Noise - Dying
Sub Focus - Falling Down
Kezwik - Problematic
Figure - Must Destroy

(DRUM & BASS)
Tim Ismag - Shanghai Flight (Quartus Saul Remix)
Ozma - Chicken Boy
Friction vs Camo & Krooked ft Dynamite MC - Stand Up (Sigma Remix)
Anile & Foreign Concept - True Enemies
Lifelink - End Game
Current Value - Delirium
Aeph - Highway Thirteen
Maztek - Funk Me Hard

