Aleksey Sladkov, Matthew Preffekt & Sasha August - Bounty (Original Mix) (Cut From Anderson Set)-enTc.mp3
Alexander One & Davide Battista - Panarea Sunrise (Original Mix) (Cut From Anderson Set)-enTc.mp3
Allen Watts - Split Second (Original Mix) (ASOT 576 Rip)-enTc.mp3
Ascania - Constellation (Neutronix & Wlad X Remix) (Cut From Anderson Set)-enTc.mp3
August Rush - White Eagle (Original Mix) (Cut From Anderson Set)-enTc.mp3
Cut Knob - Lights Out (GDJB Rip)-enTc.mp3
Dash Berlin feat. Band of Horses - The Funeral (ASOT 576 Rip) (┬½ΓÇó┬╗)-enTc.mp3
Dmitry Golban - Next Time (Original Mix) (Cut From Anderson Set)-enTc.mp3
Faruk Sabanci - Elveda (Original Mix) (ASOT 576 Rip) (┬½ΓÇó┬╗)-enTc.mp3
Holbrook & Sky Keeper - Midnight Avenue (Azima Alternative Mix) (Cut From Anderson Set)-enTc.mp3
James Dymond & Atlantia - Imperium (ASOT 576 Rip)-enTc.mp3
Luke Terry - No Control (James Dymond Remix) (ASOT 576 Rip)-enTc.mp3
Markus Schulz & Mr. Pit - Push the Button (GDJB Rip)-enTc.mp3
Markus Schulz & Mr.Pit - Push The Button (Original Mix) (ASOT 576 Rip)-enTc.mp3
Markus Schulz - Don't Leave Until the Sunrise (-Short- GDJB Rip)-enTc.mp3
Markus Schulz Featuring Adina Butar - Universe is Mine (GDJB Rip)-enTc.mp3
Markus Schulz Featuring Aruna - Sing Me Back to Life (GDJB Rip)-enTc.mp3
Markus Schulz Featuring Mark Frisch - Absolution (GDJB Rip)-enTc.mp3
Markus Schulz Featuring Seri - Love Rain Down (4 Strings Remix) (GDJB Rip)-enTc.mp3
Marlo Ayuda - Skyline (GDJB Rip)-enTc.mp3
Matt Bukovski - Retrospection (ASOT 576 Rip)-enTc.mp3
Mavvrick - Tonight (Original Mix) (Cut From Anderson Set)-enTc.mp3
Moonbeam - Disappearance (Azima Remix) (Cut From Anderson Set)-enTc.mp3
Moonbeam Featuring Jacob A - Only You (Dub Mix) (GDJB Rip)-enTc.mp3
Paul van Dyk feat. Plumb - Don't Deserve You (Giuseppe Ottaviani Remix) (ASOT 576 Rip)-enTc.mp3
Rishabh Joshi - Polarize (Original Mix) (Cut From Anderson Set) (┬½ΓÇó┬╗)-enTc.mp3
Rubicon 7 - You Fall Down (Dub Mix) (GDJB Rip)-enTc.mp3
Sebastian Brandt - Java (Chris Metcalfe Remix) (Cut From Metcalfe Set)-enTc.mp3
StudioSnap - Friendly (Original Mix) (Cut From Anderson Set)-enTc.mp3
Talla 2XLC & Surpresa - Silver (Jorn van Deynhoven Fix) (ASOT 576 Rip)-enTc.mp3
Templ8 - Tokyo (Original Mix) (Cut From Anderson Set)-enTc.mp3
Tomas Heredia - The Witch (Original Mix) (ASOT 576 Rip)-enTc.mp3
Tritonal Feat. Cristina Soto - Still With Me (Stoneface & Terminal Remix) (ASOT 576 Rip)-enTc.mp3
UNKNOWN - UNTITLED (Wellenrausch┬┤s Dark Matter Remix) (GDJB Rip)-enTc.mp3
Wellenrausch - UNTITLED (Instrumental Mix) (GDJB Rip)-enTc.mp3
York & Steve Brian - Salida Del Sol (York's Album Mix) (GDJB Rip)-enTc.mp3
