Tiesto & Allure – Pair Of Dice [Musical Freedom]
Dany Avila – Breaking Your Fall
Shermanology & R3hab – Living 4 The City [Spinnin]
Anakyn – Point Blank [FFRR]
The Bloody Beetroots – Chronicles Of A Fallen Love (feat. Greta Svabo) [Ultra]
Hot Natured & Ali Love – Benediction [Hot Creations]
Calvin Harris – Thinking About You (feat. Ayah Marar)
French Fries – Space & Smoke (Justin Martin Remix) [Dirtybird]
Santé – Homegirl (Rampa Remix) (feat. Lorenzo Hall) [Defected]
Maceo Plex – Love Somebody Else (feat. Jon Dasilva) [Ellum]
Ejeca – Night Rays [W&O Street Tracks]
Infinity Ink – Infinity (Richie Ahmed Remix) [Hot Creations]
Pete Dafeat – Hit Em Up [Lost My Dog]
Ben Pearce – What I Might Do [MTA]
Disclosure – Latch (Jamie Jones Remix) [PMR]
Julio Bashmore – Husk [Broadwalk Records]
Finnebassen – Footsteps [Supernature]
Perseus – Cool Runnings [French Express]
Odd Parents & Maceo Plex – Get Enough [Leftroom]
Icona Pop – I Love It (Style Of Eye Remix)
Matt Tolfrey feat Jem Cooke & Kevin Knapp – Distant Story [Leftroom]
Rob Mello – Fantasize (Matt Tolfrey Remix) [Classic]
Pépé Bradock – Vermeille [Versatile]
Finebassen – Footsteps [Supernature]
Perseus – Cool Runnings [French Express]
Art Department & Blud & Shaun Reeves – Robot Heart (feat. Damien Lazarus) [No19 Music]
George Fitzgerald – Every Inch (Deetron Remix) [Hypercolour]
Knights of the Hunted – X The Beat [Classic]
Sinisa Tamamovic – Broken Machine [Sci+Tec Digital]
Oscar Luweez – Metemphyschosis [Luweez Beats]
Tigerskin – Bubble Dress