Sven Vath - Live @ Balaton Sound 2012 (Hungary,Siófok)  2012.07.13.
(minimal , techno - liveset)

Audio : 44100Hz  128 kb/s tot , Stereo   MPEG-1 Layer 3
Size  : 219 MB  03:59:36



Tracklist:

Joseph Capriati & Adam Beyer – Congenial Endeavor (Original Mix)
Kaiserdisco – Aymara (Original Mix)
Caytas & Patz – Are You Afraid (Nihad Tule Remix)
Mark Reeve – Planet Green (Original Mix
Timo Maas – Kick 1 Kick 3 (Maetrik Sexy Remix)
Maetrik – The Reason (Original Mix
I-Cube – Transpiration (Original Mix
Zoo Brazil – Slob (Nick Curly Remix)
Heiko Laux Teo Schulte – Polyrhythm (Original Mix)
Tom Trago – What You Do feat. Tyree Cooper (KiNK’s Full Remix
Terranova Feat. Tomas Hoffding – Question Mark (Adam Port Remix
Emerson Todd – Inside Out (Mathias Kaden’s Storm Remix
wAFF – Jo Johnso
Kiki – Clap II Thizz (Original Versio
Reboot – Bucaboca (Original Mix)
Alden Tyrell ft Mike Dunn – Touch The Sky (Gerds Double G Rmx
Margot – Liuff Settant
I Cube – Y.O.U.R.O.C.K
Seuil – Ultravision feat. Jaw
UNER – Sol (Original Mix)
Guy J – Fixation (Original Mix)
Ray Kajioka – Thrill (Original Mix)
Exercise One – Top Score
Mark Broom – Satellite (Mix One)
Planetary Assault Systems – Black Tea (Original Mix)
Mike Dehnert – Pneumatic
Sawlin – Datamen Working
Jonas Kopp Unbalance – Fluid (Jonas Kopp Remix)
Ben Sims – Move In Time (Original Mix)
Mark Broom – SQ18 (Rave Mix)
Matador (IE) – Kingswing (Original Mix)
Gary Beck – Feel It (Original Mix)
Mark Reeve – Dice (Original Mix)
Anthony Rother – Ape Machine (Official)
Nic Fanciulli – Movin’ On (Original Mix) 

