1Touch - At Home Among Strangers (Sound Quelle Remix) (Cut From Feel Set)-enTc.mp3
Adele - Skyfall (Mark Eteson Remix) (Cut From Eteson Set)-enTc.mp3
Agnelli & Nelson - Everyday (David Howard Remix) (Cut From N-Key Set)-enTc.mp3
Akira Project - Alicia ( Original Mix) (Cut From N-Key Set)-enTc.mp3
Alan V - The Thing Is (Cut From Myon Set) (┬½ΓÇó┬╗)-enTc.mp3
Aligator - Against All Odds (Cut From Tasev Set) (┬½ΓÇó┬╗)-enTc.mp3
Allan Mcluhan & Sturmvogel pres I.N.S.A.N.E - Last Cigarette (Original Mix) (Cut From El-Jay Set)-enTc.mp3
Almar - No Sleep (Cut From Solarstone Set)-enTc.mp3
Astuni - Dedicated (Nerd Remix) (Cut From N-Key Set)-enTc.mp3
Avi - Mainstage (Original Mix) (Cut From Suzy Set)-enTc.mp3
Avis Vox pres Loolacoma - Cold Violet Skies (ASYS Remix) (Cut From Feel Set)-enTc.mp3
Biologik - Dunes (Cut From Solarstone Set)-enTc.mp3
Bissen - Riptide (Original Mix) (Cut From Kaeno Set)-enTc.mp3
BluEye - Embrace You (Original Mix) (Cut From El-Jay Set)-enTc.mp3
Brian Flinn - Cassandra (Original Mix) (Cut From Kaeno Set)-enTc.mp3
Broning - Nostagia (Almaz Remix) (Cut From N-Key Set)-enTc.mp3
Chris Baker - Final Approach (Uplifting Mix) (Cut From N-Key Set)-enTc.mp3
Daniel Rems - Stardust (Cut From Pit Set)-enTc.mp3
Daniel Wanrooy vs E&G - Alcohol Abuse (Cut From Wanrooy Set)-enTc.mp3
Darkployers - Incite (Patryk Solecki Remix) (Cut From Pit Set)-enTc.mp3
Derek Howell - Make A Run For It (Cut From Solarstone Set) (┬½ΓÇó┬╗)-enTc.mp3
DJ Ange - Lumineux (Johan Ekman Remix) (Cut From El-Jay Set)-enTc.mp3
DJ Ange - Lumineux (Johan Ekman Remix) (Cut From Saux Set)-enTc.mp3
Dominik Dudek - The Fallen (Plexland Remix) (Cut From N-Key Set)-enTc.mp3
Ehren Stowers - Split Souce (Cut From Solarstone Set)-enTc.mp3
Estigma Feat. Ren - Heartbeat (Kaimo K's Solution) (Cut From El-Jay Set)-enTc.mp3
Fernie - Voyager (Moxa Remix) (Cut From Fernie Set)-enTc.mp3
Ferry Corsten - Silfra (Original Mix) (Cut From Feel Set)-enTc.mp3
Frank Dueffel - Tonic Water (Full Force Mix) (Cut From Kaeno Set)-enTc.mp3
Fred Numf and Etienne Overdijk - Just As It Is (Cut From Wanrooy Set)-enTc.mp3
Gary Afterlife - Forever Blue (Cut From Pit Set)-enTc.mp3
Gelardi - Metropolis (Original Mix) (Cut From Feel Set)-enTc.mp3
Hadrianicus - Hymn Of The Dwarves (Original Mix) (Cut From El-Jay Set)-enTc.mp3
Kumo - You Are A Truth (Original Mix) (Cut From N-Key Set)-enTc.mp3
Lasny K - Insomnia (Cut From Trainer Set)-enTc.mp3
Lateral Cut Groove - Organised Chaos (Cut From Solarstone Set) (┬½ΓÇó┬╗)-enTc.mp3
Liam Melly & John Henderson - Take Control (Cut From Trainer Set)-enTc.mp3
Liam Melly & John Henderson - Take Control (Original Mix) (Cut From Saux Set)-enTc.mp3
Luv deluxe - Blondes vs Brunettes (Dave Schiemann Remix) (Cut From Pit Set)-enTc.mp3
Manufactured Superstars - Calling All The Lovers (Cosmic Gate Remix) (Cut From Chagall Set)-enTc.mp3
Midway - Amazon (Akira Project Remix) (Cut From N-Key Set)-enTc.mp3
Nymark & Dryden - Colours (Amir Hussain Remix) (Cut From Taylor Set) (┬½ΓÇó┬╗)-enTc.mp3
PhyGer - Sirens Tears (French Skies Remix) (Cut From Kaeno Set)-enTc.mp3
Pizz@dox - Shadow Broker (Original Mix) (Cut From Suzy Set)-enTc.mp3
Progreg - Deep Harmony (Cut From Solarstone Set) (┬½ΓÇó┬╗)-enTc.mp3
Rayko - The Cave (Ohm Fat's Transcended Mix) (Cut From Solarstone Set)-enTc.mp3
ReezOne - Polarity (Sound Players Remix) (Cut From Pit Set)-enTc.mp3
Rikkaz - Code Breaker (Original Mix) (-Short- Cut From Feel Set)-enTc.mp3
Rikkaz - Maximus (Original Mix) (Cut From Suzy Set)-enTc.mp3
Ron Hagen and Al Exander - Flight to Basu (Cut From Pit Set)-enTc.mp3
Sensetive5 & Gordey Tsukanov - Signals (Original Mix) (Cut From Trainer Set)-enTc.mp3
Setrise vs. Johann Stone - MNE (DJ Feel Remix) (Cut From Feel Set)-enTc.mp3
SHato & Paul Rockseek - Found You (Maarten de Jong Remix) (Cut From Eteson Set)-enTc.mp3
Slusnik Luna - Valssi (Orkidea Remix) (Cut From Solarstone Set)-enTc.mp3
Steve Delves - Sanctum (Sou Kanai Remix) (Cut From Saux Set)-enTc.mp3
Team Bastian - Are You Tranc-ized (Original Mix) (Cut From Kalinov Set)-enTc.mp3
Team Bastian - Tango (Cut From Trainer Set)-enTc.mp3
Traces Traxx - Day To Day (Cut From Akira Set)-enTc.mp3
York presents Iversoon & Alex Daf Feat. Eskova - I Will Survive (Erick Stong Remix) (Cut From Trainer Set)-enTc.mp3
