Tier 1 - Opening Licks
Joan Jett and the Blackhearts - I Love Rock 'n' Roll     
The Ramones - I Wanna Be Sedated     
White Zombie - Thunder Kiss '65     
Deep Purple - Smoke on the Water     
Bad Religion - Infected

Tier 2 - Axe-Grinders
Black Sabbath - Iron Man     
Boston - More Than a Feeling     
Judas Priest - You Got Another Thing Comin'     
Franz Ferdinand - Take Me Out     
ZZ Top - Sharp Dressed Man

Tier 3 - Thrash and Burn
Queen - Killer Queen     
The Exies - Hey You     
Incubus - Stellar     
Burning Brides - Heart Full of Black     
Megadeth - Symphony of Destruction

Tier 4 - Return of the Shred
David Bowie - Ziggy Stardust     
Sum 41 - Fat Lip     
Audioslave - Cochise     
The Donnas - Take It Off     
Helmet - Unsung

Tier 5 - Fret-Burners
Jimi Hendrix - Spanish Castle Magic     
The Red Hot Chili Peppers - Higher Ground     
Queens of the Stone Age - No One Knows     
Motörhead - Ace of Spades     
Cream - Crossroads

Tier 6 - Face-Melters
Blue Öyster Cult - Godzilla     
Stevie Ray Vaughan - Texas Flood     
The Edgar Winter Group - Frankenstein     
Pantera - Cowboys from Hell     
Ozzy Osbourne - Bark at the Moon

Tier 7 - Bonus Songs
Graveyard BBQ - Cheat on the Church
Shaimus - All of This 
Anarchy Club - Behind the Mask     
The Acro-brats - Callout     
The Bags - Cavemen Rejoice     
Drist - Decontrol     
The Upper Crust - Eureka, I've Found Love     
The Slip - Even Rats     
Made in Mexico - Farewell Myth     
Black Label Society - Fire It Up     
Din - Fly on the Wall     
Freezepop - Get Ready 2 Rokk     
Monkey Steals the Peach - Guitar Hero     
Honest Bob and the Factory-to-Dealer Incentives - Hey     
Count Zero - Sail Your Ship By     
The Model Sons - Story of My Love     
Artillery – The Breaking Wheel     
Andrew Buch - Trippolette     
Graveyard Shift - Windtunnel Syndrome