Las Cien Mejores Canciones Del Pop Español (2012)


	 1m² (Sólo o bien acompañado)  - Jarabe de Palo .
	 20 de abril  - Celtas Cortos .
	 Alma de blues  - Presuntos Implicados .
	 Amante bandido 99  - Miguel Bosé .
	 Amiga mía  - Alejandro Sanz .
	 Arponera   - Esclarecidos .
	 Aunque tu no lo sepas  - Enrique Urquijo y Los Problemas .
	 años 80  - Los Piratas .
	 Bonito  - Jarabe de Palo .
	 Bourbon  - Dinamita pa los Pollos .
	 Cada vez que estoy sin ti  - David DeMaría .
	 Cantos de sirena  - Inma Serrano .
	 Charla del pescado  - Juan Perro .
	 Chiquilla  - Seguridad Social .
	 Cien gaviotas  - Duncan Dhu .
	 Criticar por criticar  - Fangoria .
	 Cruce de Caminos   - Gatos Locos .
	 Cuentame un Cuento  - Celtas Cortos .
	 Dame Calidad  - Ciudad Jardin .
	 Dejame   - Los Secretos .
	 Desde Cuando  - Alejandro Sanz .
	 Desde que nos vemos  - Enrique Urquijo .
	 Devuélveme a mi chica  - Hombres G .
	 El Canto de La Sirena   - Los Limones .
	 El Movil de Lucifer  - Tam Tam Go .
	 En algún lugar  - Duncan Dhu .
	 En Sus Sueños  - 21 Japonesas .
	 Escuela de calor  - Dj Khun .
	 Espiando a Mi Vecina   - Un Pinguino en el ascensor .
	 Estoy enfermo (con Melendi)  - Pignoise .
	 Ferrol   - Los Limones .
	 Historias de Amor   - OBK .
	 La lista de la compra (feat. María Jiménez)  - La Cabra Mecánica .
	 La Lola  - Café Quijano .
	 La sirenita  - Los Caciques .
	 La Taberna del Buda  - Café Quijano .
	 Libre  - El Chaval de la Peca .
	 Los Años que Nos Quedan Por Vivir   - Los Lunes que quedan .
	 Magia en Tus Ojos  - La Granja .
	 Manuel Raquel   - Tam tam Go .
	 Maracaibo  - La Union .
	 Marta Tiene Un Marcapasos  - Hombres G .
	 Mi Pequeño Tesoro  - Presuntos Implicados .
	 No me beses en los labios  - Aerolíneas Federales .
	 No me crees  - Efecto Mariposa .
	 No Puedo Mirar  - Nacha Pop .
	 Pensando en ti  - Eray .
	 Pero a tu lado  - Los Secretos .
	 Por qué te vas  - Javier Álvarez .
	 Quiero ser como tu  - Not Recognized .
	 Retorciendo palabras  - Fangoria .
	 Ruedan  - Diego Martín .
	 Salta  - Seguridad Social .
	 Si me quisieras  - Roel .
	 Si No Estás   - Belén Arjona .
	 Si Tu No Vuleves  - Miguel Bose .
	 Sorprendentemente  - La Tercera República .
	 Supernova  - Peker .
	 Todo va bien (de momento)  - Los Sencillos .
	 Un Error de Apreciación  - La Dama Se Esconde .
	 Un lobo en Paris  - La Union .
	 Una décima de segundo  - Nacha Pop .
	 Una vez más  - Lombardi .
	 Uno Mas Uno Son 7   - Fran Perea .
	 Viviendo en La Era Pop   - Los Flechazos .
	 Voy en un coche  - Christina y Los Subterráneos .
	 Vuelve el amor  - La Uniøn .
	 Y Si Al Menos   - La Granja .

Formato MP3

256 Bytes
